smiles,num_bonds,num_rotable,num_non_rotable,rotable_proportion,non_rotable_proportion,num_hdonors,num_hacceptors
CC(C)NCC(O)COc1cccc2ccccc12.[Cl],41,9,32,0.21951219512195122,0.7804878048780488,2,3
CC(C)(C)OC(=O)CCCc1ccc(N(CCCl)CCCl)cc1,50,14,36,0.28,0.72,0,3
CC1COc2c(N3CCN(C)CC3)c(F)cc3c(=O)c(C(=O)O)cn1c23,49,5,44,0.10204081632653061,0.8979591836734694,1,7
CC(=O)NCCCOc1cccc(CN2CCCCC2)c1,48,9,39,0.1875,0.8125,1,3
Cc1onc(-c2ccccc2Cl)c1C(=O)N[C@@H]1C(=O)N2[C@@H]1SC(C)(C)[C@@H]2C(=O)O,50,9,41,0.18,0.82,2,7
CCN1CCN(C(=O)N[C@@H](C(=O)N[C@@H]2C(=O)N3C(C(=O)O)=C(CSc4nnnn4C)CS[C@H]23)c2ccc(O)cc2)C(=O)C1=O,75,16,59,0.21333333333333335,0.7866666666666666,4,14
CN(C)[C@@H]1C(=O)/C(=C(/O)NCN2CCCC2)C(=O)[C@@]2(O)C(=O)C3=C(O)c4c(O)cccc4[C@@](C)(O)[C@H]3C[C@@H]12,75,12,63,0.16,0.84,6,11
Cc1nccn1CC1CCc2c(c3ccccc3n2C)C1=O,44,4,40,0.09090909090909091,0.9090909090909091,0,4
COc1ccc([C@@H]2Sc3ccccc3N(CCN(C)C)C(=O)[C@@H]2OC(C)=O)cc1,57,11,46,0.19298245614035087,0.8070175438596491,0,6
NC(N)=NC(=O)c1nc(Cl)c(N)nc1N,23,6,17,0.2608695652173913,0.7391304347826086,4,5
CN1Cc2c(-c3noc(C(C)(O)CO)n3)ncn2-c2cccc(Cl)c2C1=O,46,7,39,0.15217391304347827,0.8478260869565217,2,8
Cc1cn([C@H]2C[C@H](F)[C@@H](CO)O2)c(=O)[nH]c1=O,31,4,27,0.12903225806451613,0.8709677419354839,2,5
ClCCl,4,0,4,0.0,1.0,0,0
CC(C)(C)NC(=O)C1CC2CCCCC2CN1CC(O)C(Cc1ccccc1)NC(=O)C(CC(N)=O)NC(=O)c1ccc2ccccc2n1,103,21,82,0.20388349514563106,0.7961165048543689,5,7
CCC(=O)C(CC(C)N(C)C)(c1ccccc1)c1ccccc1,51,11,40,0.21568627450980393,0.7843137254901961,0,2
CCC(=O)N(c1ccccc1)C1(COC)CCN(CCn2nnn(CC)c2=O)CC1,64,13,51,0.203125,0.796875,0,8
CN(C)C(=O)C(CCN1CCC(O)(c2ccc(Cl)cc2)CC1)(c1ccccc1)c1ccccc1,70,11,59,0.15714285714285714,0.8428571428571429,1,3
CN1C2CCC1CC(OC(=O)[C@H](CO)c1ccccc1)C2,46,7,39,0.15217391304347827,0.8478260869565217,1,4
COc1ccc(Cl)cc1C(=O)NCCc1ccc(S(=O)(=O)NC(=O)NC2CCCCC2)cc1,63,12,51,0.19047619047619047,0.8095238095238095,3,5
Nc1nnc(-c2cccc(Cl)c2Cl)c(N)n1,24,3,21,0.125,0.875,2,5
CCCC(C)C,19,5,14,0.2631578947368421,0.7368421052631579,0,0
C[C@H](N)Cc1ccccc1,23,4,19,0.17391304347826086,0.8260869565217391,1,1
CN(C)Cc1ccc(CSCCNc2nc(=O)c(Cc3ccc4ccccc4c3)c[nH]2)o1,63,12,51,0.19047619047619047,0.8095238095238095,2,6
CC(C)(C)NCC(O)COc1cccc2c1C[C@H](O)[C@H](O)C2,50,12,38,0.24,0.76,4,5
CCC(=O)N(c1ccccc1)C1(COC)CCN(CCc2cccs2)CC1,59,11,48,0.1864406779661017,0.8135593220338984,0,4
CCNC(=NC#N)NCCSCc1ncccc1Br,35,9,26,0.2571428571428571,0.7428571428571429,2,4
Cc1ccc(-c2nc3ccc(C)cn3c2CC(=O)N(C)C)cc1,46,8,38,0.17391304347826086,0.8260869565217391,0,3
CN1CCN(C2=c3ccccc3=Nc3ccc(Cl)cc3N2)CC1,45,2,43,0.044444444444444446,0.9555555555555556,1,4
FC(F)(F)c1ccc(N2CCNCC2)nc1Cl,29,2,27,0.06896551724137931,0.9310344827586207,1,3
CCN1CCN(C(=O)N[C@@H](C(=O)N[C@@H]2C(=O)N3[C@@H]2SC(C)(C)[C@@H]3C(=O)O)c2ccccc2)C(=O)C1=O.O,68,13,55,0.19117647058823528,0.8088235294117647,3,8
CCCC(C)C1(CC)C(=O)NC(=O)NC1=O,34,7,27,0.20588235294117646,0.7941176470588235,2,3
C[C@H]1COc2c(N3CCN(C)CC3)c(F)cc3c(=O)c(C(=O)O)cn1c23,49,5,44,0.10204081632653061,0.8979591836734694,1,7
O=C(NCCCOc1cccc(CN2CCCCC2)c1)c1ccccc1,56,9,47,0.16071428571428573,0.8392857142857143,1,3
CN1Cc2c(C(=O)OC(C)(C)C)ncn2-c2ccsc2C1=O,41,7,34,0.17073170731707318,0.8292682926829268,0,6
CCC(=O)N(c1ccccc1)C1CCN(CCc2ccccc2)CC1,55,8,47,0.14545454545454545,0.8545454545454545,0,2
CCOC(=O)c1cncn1C(C)c1ccccc1,35,7,28,0.2,0.8,0,4
CN(C)c1cc(-c2nc(N)n[nH]2)ccn1,28,5,23,0.17857142857142858,0.8214285714285714,2,5
CN1CCN(CCCN2c3ccccc3Sc3ccc(Cl)cc32)CC1,52,5,47,0.09615384615384616,0.9038461538461539,0,4
Nc1ccc(-c2nc3ccc(O)cc3s2)cc1I,29,3,26,0.10344827586206896,0.896551724137931,2,4
CC(=O)Nc1cccc(-c2csc(N=C(N)N)n2)c1,33,7,26,0.21212121212121213,0.7878787878787878,3,4
CN1[C@@H]2CCC[C@H]1CC(NC(=O)c1nn(C)c3ccccc13)C2,50,5,45,0.1,0.9,1,4
CS(=O)(=O)c1ccc([C@@H](O)[C@@H](CO)NC(=O)C(Cl)Cl)cc1,36,10,26,0.2777777777777778,0.7222222222222222,3,5
NC(N)=Nc1nc(-c2ccccc2)cs1,26,4,22,0.15384615384615385,0.8461538461538461,2,3
Cc1cccc(C)c1OCC(C)N,30,7,23,0.23333333333333334,0.7666666666666667,1,2
CCC(=O)O[C@](Cc1ccccc1)(c1ccccc1)[C@H](C)CN(C)C,55,13,42,0.23636363636363636,0.7636363636363637,0,3
CNCCCN1c2ccccc2Sc2ccc(Cl)cc21,39,5,34,0.1282051282051282,0.8717948717948718,1,3
CN(C)Cc1ccc(-c2cccc(NC3N=CC=C3[N+](=O)[O-])c2)o1,44,8,36,0.18181818181818182,0.8181818181818182,1,6
Cn1nnnc1SCC1=C(C(=O)O)N2C(=O)[C@@H](NC(=O)[C@H](O)c3ccccc3)[C@H]2SC1,52,11,41,0.21153846153846154,0.7884615384615384,3,11
CN(C)CCc1ccccn1,25,5,20,0.2,0.8,0,2
O=C1CCCN1CCCCN1CCN(c2cc(C(F)(F)F)ccn2)CC1,53,7,46,0.1320754716981132,0.8679245283018868,0,4
C=C[C@H]1CN2CC[C@H]1C[C@@H]2[C@@H](O)c1ccnc2ccc(OC)cc12,51,6,45,0.11764705882352941,0.8823529411764706,1,4
CCc1ccccc1,18,2,16,0.1111111111111111,0.8888888888888888,0,0
NC(N)=Nc1nc(-c2cccc(N)c2)cs1,28,5,23,0.17857142857142858,0.8214285714285714,3,4
CC[C@]1(O)C[C@H]2CN(CCc3c([nH]c4ccccc34)[C@@](C(=O)OC)(c3cc4c(cc3OC)N(C)[C@H]3[C@@](O)(C(=O)OC)[C@H](OC(C)=O)[C@]5(CC)C=CCN6CC[C@]43[C@@H]65)C2)C1,125,19,106,0.152,0.848,3,12
CCC(C)C(N)C1=NC(C(=O)N[C@@H](CC(C)C)C(=O)N[C@H](CCC(=O)O)C(=O)N[C@H](C(=O)NCCCC[C@@H]2NC(=O)[C@H](CC(N)=O)NC(=O)[C@@H](CC(=O)O)NC(=O)[C@H](Cc3cnc[nH]3)NC(=O)[C@@H](Cc3ccccc3)NC(=O)[C@H]([C@@H](C)CC)NC(=O)[C@@H](CCCN)NC2=O)[C@@H](C)CC)CS1,206,52,154,0.2524271844660194,0.7475728155339806,17,21
NCCCN1c2ccccc2Sc2ccc(Cl)cc21,36,4,32,0.1111111111111111,0.8888888888888888,1,3
CN(C)Cc1ccc(CSCCNc2[nH]cc(Cc3ccccc3)c2[N+](=O)[O-])o1,57,13,44,0.22807017543859648,0.7719298245614035,2,6
CNC(=NC#N)Nc1cccc(-c2csc(N=C(N)N)n2)c1,37,8,29,0.21621621621621623,0.7837837837837838,4,5
CNCCc1ccccn1,22,4,18,0.18181818181818182,0.8181818181818182,1,2
CN[C@H]1CC[C@@H](c2ccc(Cl)c(Cl)c2)c2ccccc21.[Cl-].[H+],39,3,36,0.07692307692307693,0.9230769230769231,1,1
CC[C@]1(O)C[C@H]2CN(CCc3c([nH]c4ccccc34)[C@@](C(=O)OC)(c3cc4c(cc3OC)N(C=O)[C@H]3[C@@](O)(C(=O)OC)[C@H](OC(C)=O)[C@]5(CC)C=CCN6CC[C@]43[C@@H]65)C2)C1,124,19,105,0.1532258064516129,0.8467741935483871,3,12
CC[C@H](NC(=O)c1c(C)c(-c2ccccc2)nc2ccccc12)c1ccccc1,56,8,48,0.14285714285714285,0.8571428571428571,1,2
O=S(=O)(c1ccc2cc[nH]c2c1)N1CCCC1CCN1CCC(Oc2cccc(Cl)c2)CC1,67,7,60,0.1044776119402985,0.8955223880597015,1,4
CN(C)Cc1ccnc(-c2cccc(NC3N=CC=C3[N+](=O)[O-])c2)c1,46,8,38,0.17391304347826086,0.8260869565217391,1,6
CNCCCC12CCC(c3ccccc31)c1ccccc12,47,5,42,0.10638297872340426,0.8936170212765957,1,1
c1cc(CN2CCCCC2)cc(OCCCNc2nccs2)c1,50,8,42,0.16,0.84,1,5
CN1Cc2c(-c3noc(C(C)(C)O)n3)ncn2-c2cccc(Cl)c2C1=O,45,6,39,0.13333333333333333,0.8666666666666667,1,7
CO/N=C(\C(=O)N[C@H]1C(=O)N2C(C(=O)[O-])=C(COC(C)=O)CS[C@@H]12)c1csc(N)n1.[Na+],48,12,36,0.25,0.75,2,12
NC(=O)N1c2ccccc2C2OC2c2ccccc21,34,2,32,0.058823529411764705,0.9411764705882353,1,2
C1CCCCC1,18,0,18,0.0,1.0,0,0
Cc1csc(N=C(N)N)n1,18,4,14,0.2222222222222222,0.7777777777777778,2,3
CCCN(CCC)CCc1ccc(O)c2c1CC(=O)N2,45,10,35,0.2222222222222222,0.7777777777777778,2,3
CN1C[C@@H]2c3cc(Cl)ccc3Oc3ccccc3[C@@H]2C1,39,1,38,0.02564102564102564,0.9743589743589743,0,2
CN(C)Cc1ccc(CSCCNC2N=CC=C2[N+](=O)[O-])o1,43,11,32,0.2558139534883721,0.7441860465116279,1,7
CO/N=C(\C(=O)N[C@@H]1C(=O)N2C(C(=O)O)=C(COC(N)=O)CS[C@H]12)c1ccco1,47,12,35,0.2553191489361702,0.7446808510638298,3,10
c1cc(CN2CCCCC2)cc(OCCCNc2nc3ccccc3o2)c1,57,8,49,0.14035087719298245,0.8596491228070176,1,5
Cc1cccc2c1Oc1ccccc1[C@@]1(O)CCN(C)C[C@H]21,46,3,43,0.06521739130434782,0.9347826086956522,1,3
O=[N+]([O-])C1=CC=NC1NCCSCc1ccccn1,34,7,27,0.20588235294117646,0.7941176470588235,1,6
CC[N+](C)(C)Cc1ccccc1Br.Cc1ccc(S(=O)(=O)[O-])cc1,48,8,40,0.16666666666666666,0.8333333333333334,0,3
NCCc1cn2ccccc2n1,24,3,21,0.125,0.875,1,3
Cc1ncc([N+](=O)[O-])n1CC(O)CCl,24,6,18,0.25,0.75,1,5
CCCN(CCC)CCc1cccc2c1CC(=O)N2,44,9,35,0.20454545454545456,0.7954545454545454,1,2
Clc1ccc2c(c1)[C@H]1CNC[C@H]1c1ccccc1O2,36,0,36,0.0,1.0,1,2
CN(C)CCC=C1c2ccccc2CCc2ccccc21,46,5,41,0.10869565217391304,0.8913043478260869,0,1
CO/N=C(\C(=O)N[C@@H]1C(=O)N2C(C(=O)O)=C(CSc3nc(=O)c(=O)[nH]n3C)CS[C@H]12)c1csc(N)n1,57,13,44,0.22807017543859648,0.7719298245614035,4,15
c1ccc(NCCCOc2cccc(CN3CCCCC3)c2)nc1,53,8,45,0.1509433962264151,0.8490566037735849,1,4
Cc1cccc2c1Oc1ccccc1[C@@]1(O)CCNC[C@H]21,43,2,41,0.046511627906976744,0.9534883720930233,2,3
O=[N+]([O-])C1=CC=NC1NCCSCc1ncccc1Br,34,7,27,0.20588235294117646,0.7941176470588235,1,6
COc1cc2c(c(OC)c1OC)-c1ccc(OC)c(=O)cc1C(NC(C)=O)CC2,56,11,45,0.19642857142857142,0.8035714285714286,1,6
OCCCOc1cccc(CN2CCCCC2)c1,42,7,35,0.16666666666666666,0.8333333333333334,1,3
Cc1ncsc1CCCl,17,3,14,0.17647058823529413,0.8235294117647058,0,2
CCN(CC)C(=O)Nc1ccc(OCC(O)CNC(C)(C)C)c(C(C)=O)c1,60,19,41,0.31666666666666665,0.6833333333333333,3,5
FC(F)(F)CCl,7,1,6,0.14285714285714285,0.8571428571428571,0,0
CC(C)c1nc(-c2ncn3c2CN(C)C(=O)c2c(Cl)cccc2-3)no1,44,5,39,0.11363636363636363,0.8863636363636364,0,6
CO[C@@]1(NC(=O)Cc2cccs2)C(=O)N2C(C(=O)O)=C(COC(N)=O)CS[C@@H]21,47,12,35,0.2553191489361702,0.7446808510638298,3,9
C=CC[C@H](N)c1ccccc1-c1noc2ccccc12,38,5,33,0.13157894736842105,0.868421052631579,1,3
Cc1nc2n(c(=O)c1CCN1CCC(c3noc4cc(F)ccc34)CC1)CCCC2O,62,6,56,0.0967741935483871,0.9032258064516129,1,7
CC(=O)Nc1ccc(O)cc1,20,4,16,0.2,0.8,2,2
CC(=O)Oc1ccccc1C(=O)O,21,5,16,0.23809523809523808,0.7619047619047619,1,4
O=c1ncnc2[nH][nH]cc1-2,15,0,15,0.0,1.0,2,3
CCCCC[C@H](O)/C=C/[C@H]1[C@H](O)CC(=O)[C@@H]1CCCCCCC(=O)O,59,17,42,0.288135593220339,0.711864406779661,3,5
Cn1c(=O)c2[nH]cnc2n(C)c1=O.Cn1c(=O)c2[nH]cnc2n(C)c1=O.NCCN,55,7,48,0.12727272727272726,0.8727272727272727,4,12
CCCCc1oc2ccccc2c1C(=O)c1cc(I)c(OCCN(CC)CC)c(I)c1,62,14,48,0.22580645161290322,0.7741935483870968,0,4
CC1(C)S[C@@H]2[C@H](NC(=O)[C@H](N)c3ccc(O)cc3)C(=O)N2[C@H]1C(=O)O.O.O.O,52,10,42,0.19230769230769232,0.8076923076923077,4,7
CC1(C)S[C@@H]2[C@H](NC(=O)[C@H](N)c3ccccc3)C(=O)N2[C@H]1C(=O)O,45,9,36,0.2,0.8,3,6
C[C@]12CCC(=O)C=C1CC[C@@H]1[C@@H]2CC[C@@]2(C)[C@H]1CC[C@]2(C)O,55,4,51,0.07272727272727272,0.9272727272727272,1,2
FC(F)(F)c1ccc2c(c1)N(CCCN1CCN(CCC3OCCCO3)CC1)c1ccccc1S2.O=C(O)CCC(=O)O,84,13,71,0.15476190476190477,0.8452380952380952,2,10
O=C1Nc2ccc(Cl)cc2C(c2ccccc2)=NC1O,33,2,31,0.06060606060606061,0.9393939393939394,2,3
O=c1[nH]c2ccccc2n1C1CCN(CCOc2ccccc2)CC1,51,5,46,0.09803921568627451,0.9019607843137255,1,4
COc1ccc2c3c1O[C@H]1C(=O)CC[C@@]4(O)[C@@H](C2)N(C)CC[C@]314,48,4,44,0.08333333333333333,0.9166666666666666,1,5
CN1CC[C@]23c4c5ccc(O)c4O[C@H]2C(=O)CC[C@@]3(O)[C@H]1C5,45,3,42,0.06666666666666667,0.9333333333333333,2,5
CN1CCCC(CN2c3ccccc3Sc3ccccc32)C1,47,3,44,0.06382978723404255,0.9361702127659575,0,3
NC1=NC(=O)C(c2ccccc2)O1,22,2,20,0.09090909090909091,0.9090909090909091,1,3
CC(C)=CCN1CC[C@@]2(C)c3cc(O)ccc3C[C@@H]1[C@H]2C,50,7,43,0.14,0.86,1,2
CCc1cc(C(N)=S)ccn1,21,4,17,0.19047619047619047,0.8095238095238095,1,2
COc1cc([C@@H]2c3cc4c(cc3[C@@H](O[C@@H]3O[C@@H]5CO[C@@H](C)O[C@H]5[C@H](O)[C@H]3O)C3COC(=O)[C@@H]32)OCO4)cc(OC)c1O,80,11,69,0.1375,0.8625,3,13
NC(N)=Nc1nc(CSCCC(N)=NS(N)(=O)=O)cs1,35,11,24,0.3142857142857143,0.6857142857142857,4,6
OC(Cn1cncn1)(Cn1cncn1)c1ccc(F)cc1F,36,6,30,0.16666666666666666,0.8333333333333334,1,7
O=C([O-])P(=O)([O-])[O-].[Na+].[Na+].[Na+],6,1,5,0.16666666666666666,0.8333333333333334,0,5
NCC1(CC(=O)O)CCCCC1,29,5,24,0.1724137931034483,0.8275862068965517,2,3
CCOc1ccc2ccccc2c1C(=O)N[C@@H]1C(=O)N2[C@@H]1SC(C)(C)[C@@H]2C(=O)[O-].[Na+],53,9,44,0.16981132075471697,0.8301886792452831,1,6
CCn1cc(C(=O)O)c(=O)c2ccc(C)nc21,30,5,25,0.16666666666666666,0.8333333333333334,1,5
Cc1c(O)cccc1C(=O)N[C@@H](CSc1ccccc1)[C@H](O)CN1C[C@H]2CCCC[C@H]2C[C@H]1C(=O)NC(C)(C)C,88,18,70,0.20454545454545456,0.7954545454545454,4,6
COc1ccc(CCN2CCC(Nc3nc4ccccc4n3Cc3ccc(F)cc3)CC2)cc1,69,9,60,0.13043478260869565,0.8695652173913043,1,5
CN1C2CCC1CC(OC(=O)C(CO)c1ccccc1)C2,46,7,39,0.15217391304347827,0.8478260869565217,1,4
CN(C)[C@@H]1C(=O)/C(=C(\N)O)C(=O)[C@@]2(O)C(=O)C3=C(O)c4c(O)ccc(Cl)c4[C@@](C)(O)[C@H]3C[C@@H]12.[Cl-].[H+],59,10,49,0.1694915254237288,0.8305084745762712,6,10
C[C@H]1C[C@H]2[C@@H]3CCC4=CC(=O)C=C[C@]4(C)[C@@]3(F)[C@@H](O)C[C@]2(C)[C@@]1(O)C(=O)CO,60,8,52,0.13333333333333333,0.8666666666666667,3,5
CC1(C)S[C@@H]2[C@H](NC(=O)C(C(=O)O)c3ccccc3)C(=O)N2[C@H]1C(=O)O,46,10,36,0.21739130434782608,0.782608695652174,3,7
C[C@@](Cc1ccc(O)c(O)c1)(NN)C(=O)O,30,9,21,0.3,0.7,5,6
CC(C)(C)NCC(O)COc1cccc2c1CCC(=O)N2,46,10,36,0.21739130434782608,0.782608695652174,3,4
Cc1nnc(SCC2=C(C(=O)[O-])N3C(=O)[C@@H](NC(=O)Cn4cnnn4)[C@H]3SC2)s1.[Na+],45,9,36,0.2,0.8,1,13
CC(=O)OCC1=C(C(=O)O)N2C(=O)[C@@H](NC(=O)CSc3ccncc3)[C@H]2SC1,47,11,36,0.23404255319148937,0.7659574468085106,2,9
O=C(O)CCCc1ccc(N(CCCl)CCCl)cc1,38,10,28,0.2631578947368421,0.7368421052631579,1,3
CCCN1C[C@H](CSC)C[C@@H]2c3cccc4[nH]cc(c34)C[C@H]21,51,6,45,0.11764705882352941,0.8823529411764706,1,2
CN1CCN(C2=Nc3ccccc3Cc3ccccc32)CC1,46,2,44,0.043478260869565216,0.9565217391304348,0,3
OCCN1CCN(CCCN2c3ccccc3Sc3ccc(Cl)cc32)CC1,56,7,49,0.125,0.875,1,5
CCOC(=O)C1(c2ccccc2)CCN(C)CC1,40,6,34,0.15,0.85,0,3
c1ccc(C2(N3CCCCC3)CCCCC2)cc1,45,2,43,0.044444444444444446,0.9555555555555556,0,1
NNCCc1ccccc1.O=S(=O)(O)O,28,6,22,0.21428571428571427,0.7857142857142857,4,6
CCC1(c2ccccc2)C(=O)NC(=O)NC1=O,30,3,27,0.1,0.9,2,3
NC(=O)OCCCc1ccccc1,26,6,20,0.23076923076923078,0.7692307692307693,1,2
CNC(=O)Oc1ccc2c(c1)[C@]1(C)CCN(C)[C@@H]1N2C,43,7,36,0.16279069767441862,0.8372093023255814,1,4
NCC(O)c1ccc(O)c(O)c1,23,6,17,0.2608695652173913,0.7391304347826086,4,4
COc1ccc2nc(S(=O)Cc3ncc(C)c(OC)c3C)[nH]c2c1,45,9,36,0.2,0.8,1,5
Cc1onc(-c2ccccc2)c1C(=O)N[C@@H]1C(=O)N2[C@@H]1SC(C)(C)[C@@H]2C(=O)O,50,9,41,0.18,0.82,2,7
OC[C@H]1O[C@@H](n2cnc3c2NC=NC[C@H]3O)C[C@@H]1O,37,5,32,0.13513513513513514,0.8648648648648649,4,8
CC1(C)S[C@@H]2[C@H](NC(=O)COc3ccccc3)C(=O)N2[C@H]1C(=O)[O-],43,8,35,0.18604651162790697,0.813953488372093,1,6
O=C(NC(CO)C(O)c1ccc([N+](=O)[O-])cc1)C(Cl)Cl,32,9,23,0.28125,0.71875,3,5
NS(=O)(=O)c1cc2c(cc1Cl)NC=NS2(=O)=O,24,2,22,0.08333333333333333,0.9166666666666666,2,5
CCCNC(=O)NS(=O)(=O)c1ccc(Cl)cc1,30,7,23,0.23333333333333334,0.7666666666666667,2,3
CN(C)[C@@H]1C(=O)/C(=C(\N)O)C(=O)[C@@]2(O)C(=O)C3=C(O)c4c(O)ccc(Cl)c4[C@@](C)(O)[C@H]3C[C@@H]12,59,10,49,0.1694915254237288,0.8305084745762712,6,10
NS(=O)(=O)c1cc(C2(O)NC(=O)c3ccccc32)ccc1Cl,35,4,31,0.11428571428571428,0.8857142857142857,3,4
CCOC(=O)C(C)(C)Oc1ccc(Cl)cc1,31,8,23,0.25806451612903225,0.7419354838709677,0,3
CC(C)(Oc1ccc(Cl)cc1)C(=O)O,25,6,19,0.24,0.76,1,3
Clc1ccccc1C(c1ccccc1)(c1ccccc1)n1ccnc1,45,4,41,0.08888888888888889,0.9111111111111111,0,2
C[C@]12C[C@H](O)[C@H]3[C@@H](CCC4=CC(=O)CC[C@@]43C)[C@@H]1CC[C@@H]2C(=O)CO,58,6,52,0.10344827586206896,0.896551724137931,2,4
C[C@]12CCC(=O)C=C1CC[C@@H]1[C@@H]2C(=O)C[C@@]2(C)[C@H]1CC[C@]2(O)C(=O)CO,57,6,51,0.10526315789473684,0.8947368421052632,2,5
OCCC1CCN(CC/C=C2\c3ccc(F)cc3Sc3ccc(C(F)(F)F)cc32)CC1,59,7,52,0.11864406779661017,0.8813559322033898,1,3
O=c1[nH]c2ccccc2n1C1CCN(CCCC(c2ccc(F)cc2)c2ccc(F)cc2)CC1,67,7,60,0.1044776119402985,0.8955223880597015,1,3
OCCN1CCN(CC/C=C2/c3ccccc3COc3ccc(Cl)cc32)CC1,58,6,52,0.10344827586206896,0.896551724137931,1,4
NC(=O)C1(N2CCCCC2)CCN(CCCC(=O)c2ccc(F)cc2)CC1,59,8,51,0.13559322033898305,0.864406779661017,1,4
O=C1CN=C(c2ccccc2)c2cc(Cl)ccc2N1CC1CC1,43,3,40,0.06976744186046512,0.9302325581395349,0,2
CC(=O)[C@H]1CC[C@H]2[C@@H]3CC[C@@H]4C[C@H](O)CC[C@]4(C)[C@H]3CC[C@]12C,60,5,55,0.08333333333333333,0.9166666666666666,1,2
CCC1(c2ccccc2)C(=O)NCNC1=O,31,3,28,0.0967741935483871,0.9032258064516129,2,2
CCN(CC)CCOC(=O)c1ccc(N)cc1,37,10,27,0.2702702702702703,0.7297297297297297,1,4
OC(CCN1CCCC1)(c1ccccc1)C1CCCCC1,52,6,46,0.11538461538461539,0.8846153846153846,1,2
CN(C)CCCN1c2ccccc2Sc2ccccc21,42,6,36,0.14285714285714285,0.8571428571428571,0,3
CC(C)NCC(O)COc1cccc2[nH]ccc12,39,9,30,0.23076923076923078,0.7692307692307693,3,3
CO[C@H](C(=O)[C@@H](O)[C@@H](C)O)[C@@H]1Cc2cc3cc(O[C@H]4C[C@@H](O[C@H]5C[C@@H](O)[C@H](O)[C@@H](C)O5)[C@H](O)[C@@H](C)O4)c(C)c(O)c3c(O)c2C(=O)[C@H]1O[C@H]1C[C@@H](O[C@H]2C[C@@H](O[C@H]3C[C@](C)(O)[C@H](O)[C@@H](C)O3)[C@H](O)[C@@H](C)O2)[C@H](O)[C@@H](C)O1,159,35,124,0.22012578616352202,0.779874213836478,11,24
CC[C@H](C)C(=O)O[C@H]1C[C@H](O)C=C2C=C[C@H](C)[C@H](CC[C@@H](O)C[C@@H](O)CC(=O)O)[C@H]21,67,18,49,0.26865671641791045,0.7313432835820896,4,7
O=C(C1CCCCC1)N1CC(=O)N2CCc3ccccc3C2C1,50,2,48,0.04,0.96,0,2
COc1cc(Cc2cnc(N)nc2N)cc(OC)c1OC,40,10,30,0.25,0.75,2,7
COc1cc(NCc2ccc3nc(N)nc(N)c3c2C)cc(OC)c1OC,52,12,40,0.23076923076923078,0.7692307692307693,3,8
NC(CO)(CO)CO,18,7,11,0.3888888888888889,0.6111111111111112,4,4
NC1[C@H]2CN(c3nc4c(cc3F)c(=O)c(C(=O)O)cn4-c3ccc(F)cc3F)C[C@@H]12,49,5,44,0.10204081632653061,0.8979591836734694,2,7
NC(N)=O,7,2,5,0.2857142857142857,0.7142857142857143,2,1
O=c1ccc2ccccc2o1,18,0,18,0.0,1.0,0,2
Nc1ccc(S(=O)(=O)c2ccc(N)cc2)cc1,30,4,26,0.13333333333333333,0.8666666666666667,2,4
C[C@H](CCC(=O)O)[C@H]1CC[C@H]2[C@@H]3C(=O)C[C@@H]4CC(=O)CC[C@]4(C)[C@H]3CC(=O)[C@]12C,66,8,58,0.12121212121212122,0.8787878787878788,1,5
O=c1c(Cc2c(O)oc3ccccc3c2=O)c(O)oc2ccccc12,40,4,36,0.1,0.9,2,6
CCN(CC)CCOC(=O)C1(C2CCCCC2)CCCCC1,58,10,48,0.1724137931034483,0.8275862068965517,0,3
CC/C(=C(/CC)c1ccc(O)cc1)c1ccc(O)cc1,41,8,33,0.1951219512195122,0.8048780487804879,2,2
C[C@H]1O[C@@H](O[C@H]2[C@@H](O)C[C@H](O[C@H]3[C@@H](O)C[C@H](O[C@H]4CC[C@@]5(C)[C@H](CC[C@@H]6[C@@H]5CC[C@]5(C)[C@H](C7=CC(=O)OC7)CC[C@]65O)C4)O[C@@H]3C)O[C@@H]2C)C[C@H](O)[C@@H]1O,125,17,108,0.136,0.864,5,13
C[C@H]1O[C@@H](O[C@H]2[C@@H](O)C[C@H](O[C@H]3[C@@H](O)C[C@H](O[C@H]4CC[C@@]5(C)[C@H](CC[C@@H]6[C@@H]5C[C@@H](O)[C@]5(C)[C@@H](C7=CC(=O)OC7)CC[C@]65O)C4)O[C@@H]3C)O[C@@H]2C)C[C@H](O)[C@@H]1O,126,18,108,0.14285714285714285,0.8571428571428571,6,14
O=c1[nH]c2ccccc2n1CCCN1CCC(n2c(=O)[nH]c3cc(Cl)ccc32)CC1,58,5,53,0.08620689655172414,0.9137931034482759,2,5
CC(CN1c2ccccc2Sc2ccccc21)N(C)C,42,6,36,0.14285714285714285,0.8571428571428571,0,3
CCC(=O)c1ccc2c(c1)N(CC(C)N(C)C)c1ccccc1S2,50,9,41,0.18,0.82,0,4
CC(C)c1cccc(C(C)C)c1O,31,7,24,0.22580645161290322,0.7741935483870968,1,1
CNCCCC1c2ccccc2C=Cc2ccccc21,43,5,38,0.11627906976744186,0.8837209302325582,1,1
O=c1cc[nH]nc1,11,0,11,0.0,1.0,1,2
Fc1ccccc1C1=NCC(=S)N(CC(F)(F)F)c2ccc(Cl)cc21,38,3,35,0.07894736842105263,0.9210526315789473,0,2
COC(=O)[C@H]1[C@H]2C[C@@H]3c4[nH]c5cc(OC)ccc5c4CCN3C[C@H]2C[C@@H](OC(=O)/C=C/c2cc(OC)c(OC)c(OC)c2)[C@@H]1OC,93,17,76,0.1827956989247312,0.8172043010752689,1,10
COC(=O)[C@H]1[C@H]2C[C@@H]3c4[nH]c5cc(OC)ccc5c4CCN3C[C@H]2C[C@@H](OC(=O)c2cc(OC)c(OC)c(OC)c2)[C@@H]1OC,89,16,73,0.1797752808988764,0.8202247191011236,1,10
C=CCC1(C(C)CCC)C(=O)NC(=O)NC1=O,35,7,28,0.2,0.8,2,3
O=C1CSC2(CCN(CCCN3c4ccccc4Sc4ccc(Cl)cc43)CC2)N1.[Cl-].[H+],57,4,53,0.07017543859649122,0.9298245614035088,1,5
O=C1C(=O)c2ccccc2C(O)=C1C1CCC(c2ccc(Cl)cc2)CC1,48,3,45,0.0625,0.9375,1,3
O=C(O)CCCCCCCC(=O)O,28,10,18,0.35714285714285715,0.6428571428571429,2,4
CC[C@H]1OC(=O)[C@H](C)[C@@H](O[C@H]2C[C@@](C)(OC)[C@@H](O)[C@H](C)O2)C(C)[C@@H](O[C@@H]2O[C@H](C)C[C@H](N(C)C)[C@H]2O)[C@](C)(O)C[C@@H](C)CN(C)[C@H](C)[C@@H](O)[C@]1(C)O,126,26,100,0.20634920634920634,0.7936507936507936,5,14
CC(C[N+](C)(C)C)OC(N)=O.[Cl-],27,9,18,0.3333333333333333,0.6666666666666666,1,2
CC(C)C[C@H]1C(=O)N2CCC[C@H]2[C@]2(O)O[C@](NC(=O)[C@@H]3C=C4c5cccc6[nH]c(Br)c(c56)C[C@H]4N(C)C3)(C(C)C)C(=O)N12,89,12,77,0.1348314606741573,0.8651685393258427,3,6
CO[C@]12CC[C@@]3(C[C@@H]1[C@](C)(O)C(C)(C)C)[C@H]1Cc4ccc(O)c5c4[C@@]3(CCN1CC1CC1)[C@H]2O5,81,12,69,0.14814814814814814,0.8518518518518519,2,5
NCCc1ccc(O)c(O)c1,22,5,17,0.22727272727272727,0.7727272727272727,3,3
COc1cccc2c1C(=O)c1c(O)c3c(c(O)c1C2=O)C[C@@](O)(C(=O)CO)C[C@@H]3O[C@H]1C[C@H](N)[C@H](O)[C@H](C)O1,72,13,59,0.18055555555555555,0.8194444444444444,6,12
C[C@H]1c2cccc(O)c2C(O)=C2C(=O)[C@]3(O)C(=O)/C(=C(/N)O)C(=O)[C@@H](N(C)C)[C@@H]3[C@@H](O)[C@@H]21.O,61,10,51,0.16393442622950818,0.8360655737704918,6,10
CCCCOc1ccc(C(=O)CCN2CCCCC2)cc1.[Cl],49,9,40,0.1836734693877551,0.8163265306122449,0,3
Clc1ccc(COC(Cn2ccnc2)c2ccc(Cl)cc2Cl)cc1,41,6,35,0.14634146341463414,0.8536585365853658,0,3
CC(C)[C@H](NC(=O)[C@H](Cc1ccccc1)NC(=O)CNC(=O)[C@@H](C)NC(=O)[C@@H](N)Cc1ccc(O)cc1)C(N)=O,79,24,55,0.3037974683544304,0.6962025316455697,7,7
CN[C@@H](C)[C@H](O)c1ccccc1,27,6,21,0.2222222222222222,0.7777777777777778,2,2
CNC[C@H](O)c1ccc(O)c(O)c1,26,7,19,0.2692307692307692,0.7307692307692307,4,4
CC[C@H]1OC(=O)[C@H](C)[C@@H](O[C@H]2C[C@@](C)(OC)[C@@H](O)[C@H](C)O2)[C@H](C)[C@@H](O[C@@H]2O[C@H](C)C[C@H](N(C)C)[C@H]2O)[C@](C)(O)C[C@@H](C)C(=O)[C@H](C)[C@@H](O)[C@]1(C)O,120,25,95,0.20833333333333334,0.7916666666666666,5,14
C[C@]12CC[C@@H]3c4ccc(O)cc4CC[C@H]3[C@@H]1CC[C@@H]2O,47,3,44,0.06382978723404255,0.9361702127659575,2,2
Nc1c2c(nc3ccccc13)CCCC2,31,1,30,0.03225806451612903,0.967741935483871,1,2
CN1C(=O)C(O)N=C(c2ccccc2)c2cc(Cl)ccc21,36,3,33,0.08333333333333333,0.9166666666666666,1,3
COc1cc2c(cc1OC)C1CC(=O)C(CC(C)C)CN1CC2,52,8,44,0.15384615384615385,0.8461538461538461,0,4
CCCCCc1cc(O)c2c(c1)OC(C)(C)[C@@H]1CCC(C)=C[C@@H]21,55,9,46,0.16363636363636364,0.8363636363636363,1,2
COC1=CC=C2[C@H]3Cc4ccc(OC)c5c4[C@@]2(CCN3C)[C@H]1O5,48,5,43,0.10416666666666667,0.8958333333333334,0,4
CCSc1ccc2c(c1)N(CCCN1CCN(C)CC1)c1ccccc1S2,59,8,51,0.13559322033898305,0.864406779661017,0,5
CSc1ccc2c(c1)N(CCC1CCCCN1C)c1ccccc1S2,54,6,48,0.1111111111111111,0.8888888888888888,0,4
CN1CCN(CC/C=C2\c3ccccc3Sc3ccc(S(=O)(=O)N(C)C)cc32)CC1,62,8,54,0.12903225806451613,0.8709677419354839,0,5
N[C@@H]1C[C@H]1c1ccccc1.[Cl-].[H+],22,2,20,0.09090909090909091,0.9090909090909091,1,1
O=c1n(CCCN2CCN(c3cccc(Cl)c3)CC2)nc2ccccn12,51,5,46,0.09803921568627451,0.9019607843137255,0,6
CS(=O)(=O)OCCCCOS(C)(=O)=O,27,9,18,0.3333333333333333,0.6666666666666666,0,6
CC1=C(C(=O)O)N2C(=O)[C@@H](NC(=O)[C@H](N)C3=CCC=CC3)[C@H]2SC1,45,8,37,0.17777777777777778,0.8222222222222222,3,6
CCN(CC)CCCC(C)Nc1ccnc2cc(Cl)ccc12,49,11,38,0.22448979591836735,0.7755102040816326,1,3
COc1cc(N)c(Cl)cc1C(=O)NC1CCN(CCCOc2ccc(F)cc2)CC1OC.O,65,13,52,0.2,0.8,2,6
Nc1nc(Cl)nc2c1ncn2[C@H]1C[C@H](O)[C@@H](CO)O1,33,5,28,0.15151515151515152,0.8484848484848485,3,8
C[N+]12CCC(CC1)C(OC(=O)C(O)(c1ccccc1)c1ccccc1)C2.[Br-],55,7,48,0.12727272727272726,0.8727272727272727,1,3
C[C@]12CC[C@@H]3c4ccc(O)cc4CC[C@H]3[C@@H]1CCC2=O,45,2,43,0.044444444444444446,0.9555555555555556,1,2
C=C(CC)C(=O)c1ccc(OCC(=O)O)c(Cl)c1Cl,31,8,23,0.25806451612903225,0.7419354838709677,1,4
C#C[C@]1(O)CC[C@H]2[C@@H]3CCc4cc(O)ccc4[C@H]3CC[C@@]21C,49,3,46,0.061224489795918366,0.9387755102040817,2,2
CC(Cc1ccc(O)cc1)NCC(O)c1cc(O)cc(O)c1,44,11,33,0.25,0.75,5,5
O=c1[nH]c(=O)n([C@H]2C[C@H](O)[C@@H](CO)O2)cc1F,29,4,25,0.13793103448275862,0.8620689655172413,3,6
Cc1onc(-c2c(F)cccc2Cl)c1C(=O)N[C@@H]1C(=O)N2[C@@H]1SC(C)(C)[C@@H]2C(=O)O,50,9,41,0.18,0.82,2,7
O=c1[nH]cc(F)c(=O)[nH]1,12,0,12,0.0,1.0,2,2
NS(=O)(=O)c1cc(C(=O)O)c(NCc2ccco2)cc1Cl,33,7,26,0.21212121212121213,0.7878787878787878,3,6
Nc1nc(=O)c2ncn(COC(CO)CO)c2[nH]1,32,8,24,0.25,0.75,4,8
C[N+]1(C)CCC(OC(=O)C(O)(c2ccccc2)C2CCCC2)C1.[Br-],53,8,45,0.1509433962264151,0.8490566037735849,1,3
O=C(CCCN1CCC(O)(c2cccc(C(F)(F)F)c2)CC1)c1ccc(F)cc1,54,8,46,0.14814814814814814,0.8518518518518519,1,3
CN(C)CCCN1c2ccccc2Sc2ccc(C(F)(F)F)cc21,45,7,38,0.15555555555555556,0.8444444444444444,0,3
CN1CCN(CCCN2c3ccccc3Sc3ccc(C(F)(F)F)cc32)CC1,55,6,49,0.10909090909090909,0.8909090909090909,0,4
OC(CCN1CCCCC1)(c1ccccc1)C1CCCCC1,55,6,49,0.10909090909090909,0.8909090909090909,1,2
COc1cc(C(=O)N2CCOCC2)cc(OC)c1OC,40,8,32,0.2,0.8,0,5
CC(CN(C)C)CN1c2ccccc2CCc2ccccc21,50,7,43,0.14,0.86,0,2
CCCCNC(=O)OCC(C)(CCC)COC(N)=O,44,16,28,0.36363636363636365,0.6363636363636364,2,4
O=c1ccn(C2OC(CO)C(O)C2O)c(=O)[nH]1,30,5,25,0.16666666666666666,0.8333333333333334,4,7
CCCC(CCC)C(=O)O,25,8,17,0.32,0.68,1,2
CN(C)C/C=C(/c1ccc(Br)cc1)c1cccnc1,37,6,31,0.16216216216216217,0.8378378378378378,0,2
CC(C)N=c1cc2n(-c3ccc(Cl)cc3)c3ccccc3nc-2cc1Nc1ccc(Cl)cc1,59,6,53,0.1016949152542373,0.8983050847457628,1,4
COc1cc2c(c(OC)c1OC)-c1ccc(OC)c(=O)cc1[C@@H](NC(C)=O)CC2,56,11,45,0.19642857142857142,0.8035714285714286,1,6
O=C(O)c1cc(=O)c2cc(OCC(O)COc3cccc4oc(C(=O)O)cc(=O)c34)ccc2o1,53,11,42,0.20754716981132076,0.7924528301886793,3,11
NC1CONC1=O,13,1,12,0.07692307692307693,0.9230769230769231,2,3
NC(=O)NO,8,3,5,0.375,0.625,3,2
CC(C)[N+]1(C)C2CCC1CC(OC(=O)C(CO)c1ccccc1)C2.[Br-],56,10,46,0.17857142857142858,0.8214285714285714,1,3
NC(N)=N/N=C/c1c(Cl)cccc1Cl,22,4,18,0.18181818181818182,0.8181818181818182,2,2
NC(N)=NCCN1CCCCCCC1,36,5,31,0.1388888888888889,0.8611111111111112,2,2
CN1C2CCC1CC(OC(=O)C(O)c1ccccc1)C2,43,6,37,0.13953488372093023,0.8604651162790697,1,4
NNc1nncc2ccccc12,21,2,19,0.09523809523809523,0.9047619047619048,2,4
NS(=O)(=O)c1cc2c(cc1Cl)NCNS2(=O)=O,26,2,24,0.07692307692307693,0.9230769230769231,3,5
C[C@]12CCC(=O)C=C1CC[C@@H]1[C@@H]2[C@@H](O)C[C@@]2(C)[C@H]1CC[C@]2(O)C(=O)CO,59,7,52,0.11864406779661017,0.8813559322033898,3,5
NS(=O)(=O)c1cc2c(cc1C(F)(F)F)NCNS2(=O)=O,29,3,26,0.10344827586206896,0.896551724137931,3,5
CC(C)Cc1ccc(C(C)C(=O)O)cc1,33,8,25,0.24242424242424243,0.7575757575757576,1,2
COc1ccc2c(c1)c(CC(=O)O)c(C)n2C(=O)c1ccc(Cl)cc1,43,8,35,0.18604651162790697,0.813953488372093,1,5
CN1Cc2c(-c3noc([C@](C)(O)CO)n3)ncn2-c2cccc(Cl)c2C1=O,46,7,39,0.15217391304347827,0.8478260869565217,2,8
NCCc1cn2ccccc2n1,24,3,21,0.125,0.875,1,3
C=C1Cc2c(CCN(CCC)CCC)ccc(O)c2N1,47,10,37,0.2127659574468085,0.7872340425531915,2,3
Cc1nc2n(c(=O)c1CCN1CCC(c3noc4cc(F)ccc34)CC1)CCC[C@H]2O,62,6,56,0.0967741935483871,0.9032258064516129,1,7
Cc1nnc2n1-c1ccc(Cl)cc1C(c1ccccc1)=NC2,38,2,36,0.05263157894736842,0.9473684210526315,0,4
O=NN(CCCl)C(=O)NCCCl,20,7,13,0.35,0.65,1,3
CCC(C)n1ncn(-c2ccc(N3CCN(c4ccc(OC[C@H]5CO[C@](Cn6cncn6)(c6ccc(Cl)cc6Cl)O5)cc4)CC3)cc2)c1=O,93,13,80,0.13978494623655913,0.8602150537634409,0,12
NCC1OC(OC2C(N)CC(N)C(OC3OC(CO)C(O)C(N)C3O)C2O)C(O)C(O)C1O,71,17,54,0.23943661971830985,0.7605633802816901,11,15
CC(C(=O)O)c1cccc(C(=O)c2ccccc2)c1,34,6,28,0.17647058823529413,0.8235294117647058,1,3
O=C(c1ccccc1)c1ccc2n1CCC2C(=O)O,34,4,30,0.11764705882352941,0.8823529411764706,1,4
C[C@H](N)[C@H](O)c1cccc(O)c1,25,6,19,0.24,0.76,3,3
NNC(=O)c1ccncc1,17,3,14,0.17647058823529413,0.8235294117647058,2,3
CC(C)NCC(O)c1ccc(O)c(O)c1,32,9,23,0.28125,0.71875,4,4
O=c1c(O[C@@H]2O[C@H](CO)[C@@H](O)[C@H](O)[C@H]2O)c(-c2ccc(O)c(O)c2)oc2cc(O)cc(O)c12,56,12,44,0.21428571428571427,0.7857142857142857,8,12
CC(=O)N1CCN(c2ccc(OC[C@H]3CO[C@](Cn4ccnc4)(c4ccc(Cl)cc4Cl)O3)cc2)CC1,68,9,59,0.1323529411764706,0.8676470588235294,0,7
CC(CCc1ccccc1)NCC(O)c1ccc(O)c(C(N)=O)c1,49,12,37,0.24489795918367346,0.7551020408163265,4,4
N[C@@H](Cc1ccc(O)c(O)c1)C(=O)O,25,7,18,0.28,0.72,4,5
OCC(O)C(O)C(O)C(O)CO,25,11,14,0.44,0.56,6,6
C=C1c2c(Cl)ccc(O)c2C(O)=C2C(=O)C3(O)C(=O)/C(=C(/N)O)C(=O)C(N(C)C)C3C(O)C12,57,9,48,0.15789473684210525,0.8421052631578947,6,10
Cc1ccc(Cl)c(Nc2ccccc2C(=O)O)c1Cl,31,5,26,0.16129032258064516,0.8387096774193549,2,3
Cc1cccc(Nc2ccccc2C(=O)O)c1C,34,6,28,0.17647058823529413,0.8235294117647058,2,3
CN=C(NC#N)NCCSCc1nc[nH]c1C,33,9,24,0.2727272727272727,0.7272727272727273,3,4
Clc1cccc(Cl)c1NC1=NCCN1,24,2,22,0.08333333333333333,0.9166666666666666,2,3
O=c1nc[nH]c2c1ncn2[C@H]1CC[C@@H](CO)O1,31,3,28,0.0967741935483871,0.9032258064516129,2,6
COCCc1ccc(OCC(O)CNC(C)C)cc1,44,13,31,0.29545454545454547,0.7045454545454546,2,4
Cc1ncc([N+](=O)[O-])n1CCO,21,5,16,0.23809523809523808,0.7619047619047619,1,5
CC#C[C@]1(O)CC[C@H]2[C@@H]3CCC4=CC(=O)CCC4=C3[C@@H](c3ccc(N(C)C)cc3)C[C@@]21C,71,6,65,0.08450704225352113,0.9154929577464789,1,3
CN(C)c1ccc(O)c2c1C[C@H]1C[C@H]3[C@H](N(C)C)C(O)=C(C(N)=O)C(=O)[C@@]3(O)C(O)=C1C2=O,63,12,51,0.19047619047619047,0.8095238095238095,5,9
O=C(NCCN1CCOCC1)c1ccc(Cl)cc1,36,5,31,0.1388888888888889,0.8611111111111112,1,3
CC(C)[N+](C)(CCOC(=O)C1c2ccccc2Oc2ccccc21)C(C)C.[Br-],59,12,47,0.2033898305084746,0.7966101694915254,0,3
NC(=O)c1cnccn1,14,2,12,0.14285714285714285,0.8571428571428571,1,3
CN(C)C(=O)Oc1ccc[n+](C)c1.[Br-],26,6,20,0.23076923076923078,0.7692307692307693,0,2
CCc1nc(N)nc(N)c1-c1ccc(Cl)cc1,31,5,26,0.16129032258064516,0.8387096774193549,2,4
C=C[C@H]1CN2CC[C@@H]1C[C@H]2[C@H](O)c1ccnc2ccc(OC)cc12,51,6,45,0.11764705882352941,0.8823529411764706,1,4
NC(Cc1ccc(N(CCCl)CCCl)cc1)C(=O)O,37,10,27,0.2702702702702703,0.7297297297297297,2,4
C[N+]1(C)CCCC(OC(=O)C(O)(c2ccccc2)c2ccccc2)C1.[Br-],53,8,45,0.1509433962264151,0.8490566037735849,1,3
COc1ccc(CN(CCN(C)C)c2ccccn2)cc1,45,10,35,0.2222222222222222,0.7777777777777778,0,4
c1ccc2c(c1)Sc1ccccc1N2CC1CN2CCC1CC2,49,2,47,0.04081632653061224,0.9591836734693877,0,3
C#C[C@]1(O)CC[C@H]2[C@@H]3CCc4cc(OC)ccc4[C@H]3CC[C@@]21C,52,4,48,0.07692307692307693,0.9230769230769231,1,2
CC[N+](C)(CC)CCOC(=O)C1c2ccccc2Oc2ccccc21,53,10,43,0.18867924528301888,0.8113207547169812,0,3
CN(Cc1cnc2nc(N)nc(N)c2n1)c1ccc(C(=O)N[C@@H](CCC(=O)O)C(=O)O)cc1,57,15,42,0.2631578947368421,0.7368421052631579,5,12
CN1C(CCl)Nc2cc(Cl)c(S(N)(=O)=O)cc2S1(=O)=O,32,4,28,0.125,0.875,2,5
C[C@](N)(Cc1ccc(O)c(O)c1)C(=O)O,28,8,20,0.2857142857142857,0.7142857142857143,4,5
COc1cccnc1CCCCNc1ncc(Cc2ccc(C)nc2)c(=O)[nH]1.[Cl-].[Cl-].[Cl-].[H+].[H+].[H+],55,11,44,0.2,0.8,2,6
CC(C)c1nc(-c2ncn3c2CN(C)C(=O)c2c(Cl)cccc2-3)no1,44,5,39,0.11363636363636363,0.8863636363636364,0,6
Cc1ccc(Cc2cnc(NCCSCc3ccc(C(C)(C)N)o3)[nH]c2=O)cn1,58,13,45,0.22413793103448276,0.7758620689655172,3,7
CN1CCN2c3ccccc3Cc3ccccc3C2C1,43,1,42,0.023255813953488372,0.9767441860465116,0,2
Cc1ncc2n1-c1ccc(Cl)cc1C(c1ccccc1F)=NC2,39,2,37,0.05128205128205128,0.9487179487179487,0,3
CC(C)c1nc(CN(C)C(=O)N[C@H](C(=O)N[C@@H](Cc2ccccc2)C[C@H](O)[C@H](Cc2ccccc2)NC(=O)OCc2cncs2)C(C)C)cs1,101,28,73,0.27722772277227725,0.7227722772277227,4,9
CC(C)(C)NC(=O)[C@@H]1C[C@@H]2CCCC[C@@H]2CN1C[C@@H](O)[C@H](Cc1ccccc1)NC(=O)[C@H](CC(N)=O)NC(=O)c1ccc2ccccc2n1,103,21,82,0.20388349514563106,0.7961165048543689,5,7
FCOC(C(F)(F)F)C(F)(F)F,14,4,10,0.2857142857142857,0.7142857142857143,0,1
CC(=O)Nc1c(I)c(NC(C)=O)c(I)c(C(=O)[O-])c1I.[Na+],28,7,21,0.25,0.75,2,4
CC(C)NCC(O)c1ccc(NS(C)(=O)=O)cc1,38,10,28,0.2631578947368421,0.7368421052631579,3,4
Cc1cn([C@H]2C=C[C@@H](CO)O2)c(=O)[nH]c1=O,29,4,25,0.13793103448275862,0.8620689655172413,2,5
CN[C@@H]1[C@H](O[C@H]2[C@H](O[C@H]3[C@H](O)[C@@H](O)[C@H](N=C(N)N)[C@@H](O)[C@@H]3N=C(N)N)O[C@@H](C)[C@]2(O)C=O)O[C@@H](CO)[C@H](O)[C@H]1O,81,22,59,0.2716049382716049,0.7283950617283951,12,15
Nc1ccc(S(=O)(=O)Nc2ncccn2)cc1,28,4,24,0.14285714285714285,0.8571428571428571,2,5
Cc1noc(NS(=O)(=O)c2ccc(N)cc2)c1C,32,6,26,0.1875,0.8125,2,5
C[C@H]1C[C@@H]2[C@H]([C@@H](O)C[C@@]3(C)[C@H]2CC[C@]3(O)C(=O)CO)[C@@]2(C)C=CC(=O)C=C12,60,8,52,0.13333333333333333,0.8666666666666667,3,5
Clc1ccc(COC(Cn2ccnc2)c2ccc(Cl)cc2Cl)c(Cl)c1,41,6,35,0.14634146341463414,0.8536585365853658,0,3
C[C@]12CC[C@H]3[C@@H](CCC4=CC(=O)CC[C@@H]43)[C@@H]1CC[C@@H]2O,49,2,47,0.04081632653061224,0.9591836734693877,1,2
CCOC(=O)C(c1c(O)oc2ccccc2c1=O)c1c(O)oc2ccccc2c1=O,49,8,41,0.16326530612244897,0.8367346938775511,2,8
OCc1cccnc1,15,2,13,0.13333333333333333,0.8666666666666667,1,2
C#C[C@]1(O)CC[C@H]2[C@@H]3CCC4=CC(=O)CC[C@@H]4[C@H]3CC[C@@]21C,51,2,49,0.0392156862745098,0.9607843137254902,1,2
NCC(O)c1cccc(O)c1,22,5,17,0.22727272727272727,0.7727272727272727,3,3
CC(CCc1ccccc1)NC(C)C(O)c1ccc(O)cc1,48,11,37,0.22916666666666666,0.7708333333333334,3,3
C[C@]12COC(=O)C[C@@H]1CC[C@@H]1[C@@H]2CC[C@@]2(C)[C@H]1CC[C@]2(C)O,55,4,51,0.07272727272727272,0.9272727272727272,1,3
O=C(O)CCc1nc(-c2ccccc2)c(-c2ccccc2)o1,39,6,33,0.15384615384615385,0.8461538461538461,1,4
CN1CCN2c3ncccc3Cc3ccccc3C2C1,42,1,41,0.023809523809523808,0.9761904761904762,0,3
Cc1ccnc2c1NC(=O)c1cccnc1N2C1CC1,37,2,35,0.05405405405405406,0.9459459459459459,1,4
FC(F)(F)c1ccc(N2CCNCC2)nc1Cl,29,2,27,0.06896551724137931,0.9310344827586207,1,3
CN/C(=C\[N+](=O)[O-])NCCSCc1ccc(CN(C)C)o1,43,13,30,0.3023255813953488,0.6976744186046512,2,7
Cc1cc(NS(=O)(=O)c2ccc(N)cc2)no1,29,5,24,0.1724137931034483,0.8275862068965517,2,5
CC/C(=C(\c1ccccc1)c1ccc(OCCN(C)C)cc1)c1ccccc1,59,11,48,0.1864406779661017,0.8135593220338984,0,2
CC1(C)S[C@@H]2[C@H](NC(=O)[C@H](C(=O)[O-])c3ccsc3)C(=O)N2[C@H]1C(=O)[O-].[Na+].[Na+],41,8,33,0.1951219512195122,0.8048780487804879,1,8
CC[C@@]1(O)C(=O)OCc2c1cc1n(c2=O)Cc2cc3c(CN(C)C)c(O)ccc3nc2-1,58,8,50,0.13793103448275862,0.8620689655172413,2,8
Nc1ccn([C@H]2CC[C@@H](CO)O2)c(=O)n1,29,4,25,0.13793103448275862,0.8620689655172413,2,6
NS(=O)(=O)Cc1noc2ccccc12,23,3,20,0.13043478260869565,0.8695652173913043,1,4
C[C@@H]1[C@H](O)[C@@H](C)/C=C\C=C/C=C\C=C/C=C\C=C/C=C\[C@H](O[C@@H]2O[C@H](C)[C@@H](O)[C@H](N)[C@@H]2O)C[C@@H]2O[C@](O)(C[C@@H](O)C[C@@H](O)[C@H](O)CC[C@@H](O)C[C@@H](O)CC(=O)O[C@H]1C)C[C@H](O)[C@H]2C(=O)O,140,19,121,0.1357142857142857,0.8642857142857143,12,18
Nc1nc(=O)c2c([nH]1)NCC(CNc1ccc(C(=O)N[C@@H](CCC(=O)[O-])C(=O)[O-])cc1)N2C=O.[Ca+2],57,12,45,0.21052631578947367,0.7894736842105263,5,11
CN(C)[C@@H]1C(=O)/C(=C(\N)O)C(=O)[C@@]2(O)C(=O)C3=C(O)c4c(O)cccc4[C@@](C)(O)[C@H]3[C@H](O)[C@@H]12.O.O,64,11,53,0.171875,0.828125,7,11
COc1ccc(Cc2nccc3cc(OC)c(OC)cc23)cc1OC,48,10,38,0.20833333333333334,0.7916666666666666,0,5
CC1(C)S[C@@H]2[C@H](NC(=O)Cc3ccccc3)C(=O)N2[C@H]1C(=O)O,43,8,35,0.18604651162790697,0.813953488372093,2,5
CCOc1ccc(NC(C)=O)cc1,26,6,20,0.23076923076923078,0.7692307692307693,1,2
Nc1ccc(N=Nc2ccccc2)c(N)n1,28,4,24,0.14285714285714285,0.8571428571428571,2,5
CN(C)CCC(c1ccccc1)c1ccccn1,39,7,32,0.1794871794871795,0.8205128205128205,0,2
O=C1OC(c2ccc(O)cc2)(c2ccc(O)cc2)c2ccccc21,41,4,37,0.0975609756097561,0.9024390243902439,2,4
CC(COc1ccccc1)N(CCCl)Cc1ccccc1,44,9,35,0.20454545454545456,0.7954545454545454,0,2
CCCCC1C(=O)N(c2ccccc2)N(c2ccccc2)C1=O,45,6,39,0.13333333333333333,0.8666666666666667,0,2
CC(C)(C)NCC(O)c1ccc(O)c(CO)n1,37,11,26,0.2972972972972973,0.7027027027027027,4,5
Cc1nc2n(c(=O)c1CCN1CCC(c3noc4cc(F)ccc34)CC1)CCCC2,61,5,56,0.08196721311475409,0.9180327868852459,0,6
CN1CC[C@@]2(C)c3cc(OC(=O)Nc4ccccc4)ccc3N(C)[C@@H]12,51,7,44,0.13725490196078433,0.8627450980392157,1,4
Cc1ccc(Cc2cnc(NCCCCc3ncc(Br)cc3C)[nH]c2=O)cn1,54,10,44,0.18518518518518517,0.8148148148148148,2,5
C#C[C@]1(O)CC[C@H]2[C@@H]3[C@H](C)CC4=C(CCC(=O)C4)[C@H]3CC[C@@]21C,54,3,51,0.05555555555555555,0.9444444444444444,1,2
CC(C)(O/N=C(\C(=O)N[C@@H]1C(=O)N2C(C(=O)[O-])=C(C[n+]3ccccc3)CS[C@H]12)c1csc(N)n1)C(=O)O,62,14,48,0.22580645161290322,0.7741935483870968,3,12
Nc1[nH]c(=O)ncc1F,13,1,12,0.07692307692307693,0.9230769230769231,2,3
NC(N)=NCC1COC2(CCCCC2)O1,35,4,31,0.11428571428571428,0.8857142857142857,2,3
O=NN(CCCl)C(=O)NC1CCCCC1,31,6,25,0.1935483870967742,0.8064516129032258,1,3
O=S(=O)([O-])CCS.[Na+],11,3,8,0.2727272727272727,0.7272727272727273,1,4
CN(N=O)C(=O)N[C@@H]1[C@@H](O)[C@H](O)[C@@H](CO)O[C@@H]1O,33,10,23,0.30303030303030304,0.696969696969697,5,8
COc1cc([C@@H]2c3cc4c(cc3[C@@H](OC3OC5COC(c6cccs6)OC5C(O)C3O)[C@H]3COC(=O)[C@H]23)OCO4)cc(OC)c1O,85,11,74,0.12941176470588237,0.8705882352941177,3,14
S=P(N1CC1)(N1CC1)N1CC1,25,3,22,0.12,0.88,0,1
CN[C@H](CC(C)C)C(=O)NC1C(=O)N[C@@H](CC(N)=O)C(=O)N[C@H]2C(=O)N[C@H]3C(=O)N[C@H](C(=O)N[C@@H](C(=O)O)c4cc(O)cc(O)c4-c4cc3ccc4O)[C@H](O)c3ccc(c(Cl)c3)Oc3cc2cc(c3O[C@@H]2O[C@H](CO)[C@@H](O)[C@H](O)[C@H]2O[C@H]2C[C@](C)(N)[C@H](O)[C@H](C)O2)Oc2ccc(cc2Cl)[C@H]1O,185,31,154,0.16756756756756758,0.8324324324324325,19,26
CN1C(CSCC(F)(F)F)Nc2cc(Cl)c(S(N)(=O)=O)cc2S1(=O)=O,39,7,32,0.1794871794871795,0.8205128205128205,2,6
C[C@]12C=CC(=O)C=C1CC[C@@H]1[C@@H]2[C@@H](O)C[C@@]2(C)[C@H]1CC[C@]2(O)C(=O)CO,57,7,50,0.12280701754385964,0.8771929824561403,3,5
C[C@]12C=CC(=O)C=C1CC[C@@H]1[C@@H]2C(=O)C[C@@]2(C)[C@H]1CC[C@]2(O)C(=O)CO,55,6,49,0.10909090909090909,0.8909090909090909,2,5
CCCN(CCC)S(=O)(=O)c1ccc(C(=O)O)cc1,38,10,28,0.2631578947368421,0.7368421052631579,1,4
CC(=O)[C@H]1CC[C@H]2[C@@H]3CCC4=CC(=O)CC[C@]4(C)[C@H]3CC[C@]12C,56,4,52,0.07142857142857142,0.9285714285714286,0,2
CC(C)NCC(O)COc1cccc2ccccc12,41,9,32,0.21951219512195122,0.7804878048780488,2,3
CC1OC(O[C@@H]2C=C3CC[C@@H]4[C@H](CC[C@]5(C)[C@@H](c6ccc(=O)oc6)CC[C@]45O)[C@@]3(C)CC2)C(O)C(O)C1O,85,10,75,0.11764705882352941,0.8823529411764706,4,8
COc1ccc(C[C@H](N)C(=O)NC2[C@@H](O)[C@H](n3cnc4c(N(C)C)ncnc43)O[C@@H]2CO)cc1,66,15,51,0.22727272727272727,0.7727272727272727,4,11
NC(=O)c1ncn([C@@H]2O[C@H](CO)[C@@H](O)[C@H]2O)n1,30,7,23,0.23333333333333334,0.7666666666666667,4,8
CN=C(NC#N)NCCSCc1csc(N=C(N)N)n1,36,11,25,0.3055555555555556,0.6944444444444444,4,6
O=C(O)/C=C\C(=O)O.O=C(O)/C=C\C(=O)O.c1cc(CN2CCCCC2)cc(OCCCNc2nc3ccccc3s2)c1,79,16,63,0.20253164556962025,0.7974683544303798,5,13
OCc1ncc2n1-c1ccc(Cl)cc1C(c1ccccc1F)=NC2,40,3,37,0.075,0.925,1,4
CC(Cl)(Cl)Cl,7,1,6,0.14285714285714285,0.8571428571428571,0,0
FC(F)(F)CCl,7,1,6,0.14285714285714285,0.8571428571428571,0,0
CC(C)CO,14,4,10,0.2857142857142857,0.7142857142857143,1,1
CCC(C)(C)C,19,5,14,0.2631578947368421,0.7368421052631579,0,0
Nc1ncnc2c1ncn2C1OC(CO)C(O)C1O,34,6,28,0.17647058823529413,0.8235294117647058,4,9
CN1Cc2c(-c3noc(C(C)(CO)CO)n3)ncn2-c2cccc(Cl)c2C1=O,49,8,41,0.16326530612244897,0.8367346938775511,2,8
CN1Cc2c(-c3noc(C(C)(C)O)n3)ncn2-c2cccc(Cl)c2C1=O,45,6,39,0.13333333333333333,0.8666666666666667,1,7
S=C(NC1CCCCC1)N1CCC(c2cnc[nH]2)CC1,46,4,42,0.08695652173913043,0.9130434782608695,2,2
COC1C=COC2(C)Oc3c(C)c(O)c4c(O)c(c(C=NN5CCN(C)CC5)c(O)c4c3C2=O)NC(=O)C(C)=CC=CC(C)C(O)C(C)C(O)C(C)C(OC(C)=O)C1C,121,20,101,0.1652892561983471,0.8347107438016529,6,15
O=C(O)c1ccccc1O,16,3,13,0.1875,0.8125,2,3
CN1[C@@H]2CC(OC(=O)[C@H](CO)c3ccccc3)C[C@H]1[C@@H]1O[C@@H]12,46,7,39,0.15217391304347827,0.8478260869565217,1,5
CC(=O)S[C@@H]1CC2=CC(=O)CC[C@]2(C)[C@H]2CC[C@@]3(C)[C@@H](CC[C@@]34CCC(=O)O4)[C@H]12,65,5,60,0.07692307692307693,0.9230769230769231,0,5
C[C@]12Cc3cn[nH]c3C[C@@H]1CC[C@@H]1[C@@H]2CC[C@@]2(C)[C@H]1CC[C@]2(C)O,60,4,56,0.06666666666666667,0.9333333333333333,2,2
O=C(O)C1=C/C(=N\Nc2ccc(S(=O)(=O)Nc3ccccn3)cc2)C=CC1=O,44,7,37,0.1590909090909091,0.8409090909090909,3,8
CC(C)N1CCN(c2ccc(OC[C@H]3CO[C@](Cn4cncn4)(c4ccc(Cl)cc4Cl)O3)cc2)CC1,71,10,61,0.14084507042253522,0.8591549295774648,0,8
C[C@]12C=CC(=O)C=C1CC[C@@H]1[C@@H]2CC[C@]2(C)OC(=O)CC[C@@H]12,49,2,47,0.04081632653061224,0.9591836734693877,0,3
C[C@]12CC[C@H]3[C@@H](CCC4=CC(=O)CC[C@@]43C)[C@@H]1CC[C@@H]2O,52,3,49,0.057692307692307696,0.9423076923076923,1,2
CN(C)[C@@H]1C(=O)/C(=C(\N)O)C(=O)[C@@]2(O)C(=O)C3=C(O)c4c(O)cccc4[C@@](C)(O)[C@H]3C[C@@H]12,59,10,49,0.1694915254237288,0.8305084745762712,6,10
CCCC(C)CC,22,6,16,0.2727272727272727,0.7272727272727273,0,0
CCC(C)CC,19,5,14,0.2631578947368421,0.7368421052631579,0,0
Cc1ncc2n1-c1ccc(Cl)cc1C(c1ccccc1F)=NC2O,40,3,37,0.075,0.925,1,4
Cc1c(N(C)C)c(=O)n(-c2ccccc2)n1C,35,6,29,0.17142857142857143,0.8285714285714286,0,4
CC(C)NCC(O)COc1ccc(CC(N)=O)cc1,41,12,29,0.2926829268292683,0.7073170731707317,3,4
c1ccccc1,12,0,12,0.0,1.0,0,0
CC(C)(C)OC(=O)c1ncn2c1[C@@H]1CCCN1C(=O)c1c(Br)cccc1-2,49,6,43,0.12244897959183673,0.8775510204081632,0,5
O=C(CCCN1CCC(O)(c2ccc(Br)cc2)CC1)c1ccc(F)cc1,51,7,44,0.13725490196078433,0.8627450980392157,1,3
OC(c1cc(C(F)(F)F)nc2c(C(F)(F)F)cccc12)C1CCCCN1,44,5,39,0.11363636363636363,0.8863636363636364,2,3
CC1COc2c(N3CCN(C)CC3)c(F)cc3c(=O)c(C(=O)O)cn1c23,49,5,44,0.10204081632653061,0.8979591836734694,1,7
CN1c2ccccc2C(c2ccccc2F)=NCC1CNC(=O)c1ccsc1,51,6,45,0.11764705882352941,0.8823529411764706,1,4
C[C@]12CCC(=O)C=C1CC[C@@H]1[C@@H]2[C@@H](O)C[C@]2(C=O)[C@@H](C(=O)CO)CC[C@@H]12,57,6,51,0.10526315789473684,0.8947368421052632,2,5
O=C(Cc1ccc(Cl)c(Cl)c1)N1CCCC[C@H]1CN1CCCC1,49,5,44,0.10204081632653061,0.8979591836734694,0,2
O=C(Cc1ccc(Cl)c(Cl)c1)N1CCc2ccccc2[C@H]1CN1CCCC1,54,5,49,0.09259259259259259,0.9074074074074074,0,2
O=C(Cc1ccc(C(F)(F)F)cc1)N1CCCC[C@H]1CN1CCCC1,52,6,46,0.11538461538461539,0.8846153846153846,0,2
O=C(Cc1ccc(Cl)c(Cl)c1)N1CCc2sccc2[C@H]1CN1CCCC1,51,5,46,0.09803921568627451,0.9019607843137255,0,3
Cn1c(=O)c2[nH]cnc2n(C)c1=O,22,2,20,0.09090909090909091,0.9090909090909091,1,5
Nc1nc(=S)c2[nH]cnc2[nH]1,17,1,16,0.058823529411764705,0.9411764705882353,3,4
Cc1ccc(S(=O)(=O)NC(=O)NN2CCCCCC2)cc1,43,6,37,0.13953488372093023,0.8604651162790697,2,4
CCCCNC(=O)NS(=O)(=O)c1ccc(C)cc1,36,9,27,0.25,0.75,2,3
C[C@]12C=CC(=O)C=C1CC[C@H]1[C@@H]3C[C@@H](O)[C@](O)(C(=O)CO)[C@@]3(C)C[C@H](O)[C@@]12F,58,8,50,0.13793103448275862,0.8620689655172413,4,6
Nc1nc(N)c2nc(-c3ccccc3)c(N)nc2n1,32,4,28,0.125,0.875,3,7
NS(=O)(=O)c1cc2c(cc1Cl)NC(C(Cl)Cl)NS2(=O)=O,29,3,26,0.10344827586206896,0.896551724137931,3,5
CC(C)C1NC(=O)[C@@H](C(C)C)OC(=O)[C@H](C(C)C)NC(=O)[C@H](C)OC(=O)[C@@H](C(C)C)NC(=O)[C@@H](C(C)C)OC(=O)[C@H](C(C)C)NC(=O)[C@H](C)OC(=O)[C@@H](C(C)C)NC(=O)[C@@H](C(C)C)OC(=O)[C@H](C(C)C)NC(=O)[C@H](C)OC1=O,168,30,138,0.17857142857142858,0.8214285714285714,6,18
COc1ccc(CCN(C)CCCC(C#N)(c2ccc(OC)c(OC)c2)C(C)C)cc1OC,72,20,52,0.2777777777777778,0.7222222222222222,0,6
CC(=O)CC(c1ccccc1)c1c(O)oc2ccccc2c1=O,41,6,35,0.14634146341463414,0.8536585365853658,1,4
CCC(C)=O,12,3,9,0.25,0.75,0,1
C1CC1,9,0,9,0.0,1.0,0,0
NCCCN1c2ccccc2CCc2ccccc21,41,4,37,0.0975609756097561,0.9024390243902439,1,2
ClCCl,4,0,4,0.0,1.0,0,0
CCOCC,14,4,10,0.2857142857142857,0.7142857142857143,0,1
C=COC=C,10,2,8,0.2,0.8,0,1
FC(F)OC(F)(F)C(F)Cl,11,3,8,0.2727272727272727,0.7272727272727273,0,1
O=C(Cc1ccc(Cl)c(Cl)c1)N1CCc2[nH]cnc2[C@H]1CN1CCCC1,51,5,46,0.09803921568627451,0.9019607843137255,1,3
CC1(C)CCN(C(=O)Cc2ccc(Cl)c(Cl)c2)[C@@H](CN2CCCC2)C1,55,7,48,0.12727272727272726,0.8727272727272727,0,2
CC(C)(C(=O)O)c1ccc(C(=O)CCCN2CCC(OC(c3ccccc3)c3ccccc3)CC2)cc1,77,14,63,0.18181818181818182,0.8181818181818182,1,5
O=C(O)COCCN1CCN(C(c2ccccc2)c2ccc(Cl)cc2)CC1,54,9,45,0.16666666666666666,0.8333333333333334,1,5
O=C(O)c1cn(C2CC2)c2cc(N3CCNCC3)c(F)cc2c1=O,45,4,41,0.08888888888888889,0.9111111111111111,2,6
CCc1c(O)c(=O)ccn1CCO,26,6,20,0.23076923076923078,0.7692307692307693,2,4
CCc1c(O)c(=O)ccn1CCCCO,32,8,24,0.25,0.75,2,4
COC(=O)[C@@H]1[C@H]2C[C@H]3c4[nH]c5ccccc5c4CCN3C[C@@H]2CC[C@@H]1O,56,4,52,0.07142857142857142,0.9285714285714286,2,4
Cc1cn([C@H]2C[C@H](N=[N+]=[N-])[C@@H](CO)O2)c(=O)[nH]c1=O,33,5,28,0.15151515151515152,0.8484848484848485,2,6
CC(=O)c1ccc2c(c1)N(CCCN(C)C)c1ccccc1S2,47,8,39,0.1702127659574468,0.8297872340425532,0,4
CC(=O)c1ccc2c(c1)N(CCCN1CCN(CCO)CC1)c1ccccc1S2,61,9,52,0.14754098360655737,0.8524590163934426,1,6
CC(=O)Nc1nnc(S(N)(=O)=O)s1,19,5,14,0.2631578947368421,0.7368421052631579,2,6
C=CCC1(CC=C)C(=O)NC(=O)NC1=O,27,4,23,0.14814814814814814,0.8518518518518519,2,3
NC12CC3CC(CC(C3)C1)C2.[Cl-].[H+],30,1,29,0.03333333333333333,0.9666666666666667,1,1
CN(C)CCC=C1c2ccccc2CCc2ccccc21,46,5,41,0.10869565217391304,0.8913043478260869,0,1
CCC1(CCC(C)C)C(=O)NC(=O)NC1=O,34,7,27,0.20588235294117646,0.7941176470588235,2,3
CC(N)Cc1ccccc1,23,4,19,0.17391304347826086,0.8260869565217391,1,1
CCO,8,2,6,0.25,0.75,1,1
CCc1ccccc1,18,2,16,0.1111111111111111,0.8888888888888888,0,0
CCOC(=O)c1ncn2c1CN(C)C(=O)c1cc(F)ccc1-2,38,5,33,0.13157894736842105,0.868421052631579,0,5
CN1C(=O)CN=C(c2ccccc2F)c2cc([N+](=O)[O-])ccc21,37,3,34,0.08108108108108109,0.918918918918919,0,4
C=COCC(F)(F)F,12,3,9,0.25,0.75,0,1
FC(F)(F)C(Cl)Br,7,1,6,0.14285714285714285,0.8571428571428571,0,0
CCCCCCC,22,6,16,0.2727272727272727,0.7272727272727273,0,0
CCCCCC,19,5,14,0.2631578947368421,0.7368421052631579,0,0
Cc1c(O)c(=O)ccn1C,19,3,16,0.15789473684210525,0.8421052631578947,1,3
CCn1ccc(=O)c(O)c1C,22,4,18,0.18181818181818182,0.8181818181818182,1,3
CCCCn1ccc(=O)c(O)c1C,28,6,22,0.21428571428571427,0.7857142857142857,1,3
CCCCCn1ccc(=O)c(O)c1C,31,7,24,0.22580645161290322,0.7741935483870968,1,3
CCCCCn1ccc(=O)c(O)c1C,31,7,24,0.22580645161290322,0.7741935483870968,1,3
Cc1c(O)c(=O)ccn1CCCO,26,6,20,0.23076923076923078,0.7692307692307693,2,4
CCc1c(O)c(=O)ccn1CC,25,5,20,0.2,0.8,1,3
CN1CCN(c2cc3c(cc2F)c(=O)c(C(=O)O)cn3-c2ccc(F)cc2)CC1,51,5,46,0.09803921568627451,0.9019607843137255,1,6
Cc1cc(=O)n(-c2ccccc2)n1C,27,3,24,0.1111111111111111,0.8888888888888888,0,3
CN1CCc2cccc3c2[C@H]1Cc1ccc(O)c(O)c1-3,40,3,37,0.075,0.925,2,3
COC(=O)C1=CCCN(C)C1,24,4,20,0.16666666666666666,0.8333333333333334,0,3
O=C(CCCN1CCN(c2ccccn2)CC1)c1ccc(F)cc1,48,6,42,0.125,0.875,0,4
CCN(CC)CCOC(=O)C(O)(c1ccccc1)c1ccccc1.[Cl-].[H+],50,12,38,0.24,0.76,1,4
O=C(CCCN1CCC(n2c(=O)[nH]c3ccccc32)CC1)c1ccc(F)cc1,55,6,49,0.10909090909090909,0.8909090909090909,1,4
CCOC(=O)c1ccc(N)cc1,23,5,18,0.21739130434782608,0.782608695652174,1,3
CCN(CC)C(=O)C1CN2CCc3cc(OC)c(OC)cc3C2CC1OC(C)=O,63,13,50,0.20634920634920634,0.7936507936507936,0,6
CN1C2CCC1CC(OC(c1ccccc1)c1ccccc1)C2.O=S(=O)(O)O,57,7,50,0.12280701754385964,0.8771929824561403,2,6
OC(CCN1CCCCC1)(c1ccccc1)C1CC2C=CC1C2,55,6,49,0.10909090909090909,0.8909090909090909,1,2
CN1C(=O)NC(=O)C(C)(C2=CCCCC2)C1=O,34,3,31,0.08823529411764706,0.9117647058823529,1,3
CC(C)(C)NC(=O)[C@@H]1CN(Cc2cccnc2)CCN1C[C@@H](O)C[C@@H](Cc1ccccc1)C(=O)N[C@H]1c2ccccc2C[C@H]1O,96,19,77,0.19791666666666666,0.8020833333333334,4,7
FC(F)OC(Cl)C(F)(F)F,11,3,8,0.2727272727272727,0.7272727272727273,0,1
C=CCC1(C(C)C#CCC)C(=O)NC(=O)N(C)C1=O,37,6,31,0.16216216216216217,0.8378378378378378,1,3
COC(F)(F)C(Cl)Cl,11,3,8,0.2727272727272727,0.7272727272727273,0,1
CC1CCCC1,18,1,17,0.05555555555555555,0.9444444444444444,0,0
CN(C)CCOC(C)(c1ccccc1)c1ccccn1,43,9,34,0.20930232558139536,0.7906976744186046,0,3
CN(C(=O)Cc1ccccc1N)[C@@H](CN1CC[C@@H](O)C1)c1ccccc1,55,10,45,0.18181818181818182,0.8181818181818182,2,4
CCn1cc(C(=O)O)c(=O)c2cc(F)c(N3CCNCC3)nc21,42,5,37,0.11904761904761904,0.8809523809523809,2,7
CN1CCN(c2c(F)cc3c(=O)c(C(=O)O)cn(CCF)c3c2F)CC1,46,6,40,0.13043478260869565,0.8695652173913043,1,6
CC(=O)N1CCN(C(=O)Cc2ccc(Cl)c(Cl)c2)[C@@H](CN2CCCC2)C1,53,7,46,0.1320754716981132,0.8679245283018868,0,3
O=C(Cc1ccc(Cl)c(Cl)c1)N1CCc2occc2[C@H]1CN1CCCC1,51,5,46,0.09803921568627451,0.9019607843137255,0,3
COC(=O)N1CCN(C(=O)Cc2ccc(Cl)c(Cl)c2)[C@@H](CN2CCCC2)C1,54,8,46,0.14814814814814814,0.8518518518518519,0,4
O=C1CN=C(c2ccccn2)c2cc(Br)ccc2N1,31,1,30,0.03225806451612903,0.967741935483871,1,3
CC(C)(C)c1ccc(CN2CCN(C(c3ccccc3)c3ccc(Cl)cc3)CC2)cc1,67,9,58,0.13432835820895522,0.8656716417910447,0,2
CN(C)CCc1c[nH]c2ccc(O)cc12,32,6,26,0.1875,0.8125,2,2
CC(NC(C)(C)C)C(=O)c1cccc(Cl)c1,34,8,26,0.23529411764705882,0.7647058823529411,1,2
O=C(NCc1ccccc1)OCCO,27,7,20,0.25925925925925924,0.7407407407407407,2,3
CCC(C)C1(CC)C(=O)NC(=O)NC1=O,31,6,25,0.1935483870967742,0.8064516129032258,2,3
Cn1c(=O)c2c(ncn2C)n(C)c1=O,25,3,22,0.12,0.88,0,6
C=C(C)[C@@H]1CCC(C)=CC1c1c(O)cc(CCCCC)cc1O,54,11,43,0.2037037037037037,0.7962962962962963,2,2
CCC(C)C(CC)C(=O)NC(N)=O,30,10,20,0.3333333333333333,0.6666666666666666,2,2
NC(=O)N1c2ccccc2C=Cc2ccccc21,32,2,30,0.0625,0.9375,1,1
CSc1ccc2c(c1)N(CCC1CCCNC1)c1ccccc1S2,51,5,46,0.09803921568627451,0.9019607843137255,1,4
Cn1c(=O)[nH]c2ncn(C)c2c1=O,22,2,20,0.09090909090909091,0.9090909090909091,1,5
CCCCC,16,4,12,0.25,0.75,0,0
CCCO,11,3,8,0.2727272727272727,0.7272727272727273,1,1
CC(C)=O,9,2,7,0.2222222222222222,0.7777777777777778,0,1
CCOC(=O)N1CCN(C(=O)Cc2ccc(Cl)c(Cl)c2)[C@@H](CN2CCCC2)C1,57,9,48,0.15789473684210525,0.8421052631578947,0,4
CCCOC(=O)N1CCN(C(=O)Cc2ccc(Cl)c(Cl)c2)[C@@H](CN2CCCC2)C1,60,10,50,0.16666666666666666,0.8333333333333334,0,4
O=C(Cc1ccc(Cl)c(Cl)c1)N1CCc2occc2[C@H]1CN1CC[C@@H](O)C1,52,6,46,0.11538461538461539,0.8846153846153846,1,4
CC(=O)N1CCN(C(=O)Cc2ccc(Cl)c(Cl)c2)[C@@H](CN2CC[C@@H](O)C2)C1,54,8,46,0.14814814814814814,0.8518518518518519,1,4
CC(=O)N1CCN(C(=O)Cc2ccc(C(F)(F)F)cc2)[C@@H](CN2CC[C@@H](O)C2)C1,57,9,48,0.15789473684210525,0.8421052631578947,1,4
CSc1ccc(CC(=O)N2CCN(C(C)=O)C[C@@H]2CN2CC[C@@H](O)C2)cc1,58,10,48,0.1724137931034483,0.8275862068965517,1,5
CC(=O)N1CCN(C(=O)Cc2cc(F)cc(F)c2)[C@@H](CN2CC[C@@H](O)C2)C1,54,8,46,0.14814814814814814,0.8518518518518519,1,4
COc1cccc(CC(=O)N2CCN(C(C)=O)C[C@@H]2CN2CC[C@@H](O)C2)c1,58,10,48,0.1724137931034483,0.8275862068965517,1,5
CC(=O)N1CCN(C(=O)Cc2ccc([N+](=O)[O-])cc2)[C@@H](CN2CC[C@H](O)C2)C1,56,9,47,0.16071428571428573,0.8392857142857143,1,6
COc1ccc(CC(=O)N2CCN(C(C)=O)C[C@@H]2CN2CC[C@@H](O)C2)cc1,58,10,48,0.1724137931034483,0.8275862068965517,1,5
CCC(=O)c1ccc2c(c1)N(CCCN1CCN(CCO)CC1)c1ccccc1S2,64,10,54,0.15625,0.84375,1,6
CCCCNc1c(C(=O)OCC)cnc2c1cnn2CC,44,11,33,0.25,0.75,1,6
Nn1cnc2cc3ccccc3cc2c1=O,27,1,26,0.037037037037037035,0.9629629629629629,1,4
OC(O)C(Cl)(Cl)Cl,9,3,6,0.3333333333333333,0.6666666666666666,2,2
CN=C1CN(O)C(c2ccccc2)=c2cc(Cl)ccc2=N1,37,3,34,0.08108108108108109,0.918918918918919,1,3
CN(C)CCCN1c2ccccc2Sc2ccc(Cl)cc21,42,6,36,0.14285714285714285,0.8571428571428571,0,3
CN(C)CC/C=C1/c2ccccc2Sc2ccc(Cl)cc21,41,5,36,0.12195121951219512,0.8780487804878049,0,2
O=c1[nH]c2cc(Cl)ccc2o1,16,0,16,0.0,1.0,1,2
C[N+](C)(C)CCO,20,6,14,0.3,0.7,1,1
CN1C(=O)CC(=O)N(c2ccccc2)c2cc(Cl)ccc21,36,2,34,0.05555555555555555,0.9444444444444444,0,2
O=C(O)CNC(=O)c1ccccc1O,23,6,17,0.2608695652173913,0.7391304347826086,3,4
CN1CCCCC1CCN1c2ccccc2Sc2ccc(S(C)(=O)=O)cc21,56,6,50,0.10714285714285714,0.8928571428571429,0,5
FC(Br)C(F)(F)F,7,1,6,0.14285714285714285,0.8571428571428571,0,0
Cn1cnc2c1c(=O)[nH]c(=O)n2C,22,2,20,0.09090909090909091,0.9090909090909091,1,5
CCCC(C)C1(CC)C(=O)NC(=S)NC1=O,34,7,27,0.20588235294117646,0.7941176470588235,2,3
Cc1ccccc1,15,1,14,0.06666666666666667,0.9333333333333333,0,0
Cc1nnc2n1-c1ccc(Cl)cc1C(c1ccccc1Cl)=NC2,38,2,36,0.05263157894736842,0.9473684210526315,0,4
CC(=O)N1CCN(C(=O)Cc2cccc([N+](=O)[O-])c2)[C@@H](CN2CC[C@H](O)C2)C1,56,9,47,0.16071428571428573,0.8392857142857143,1,6
CC(=O)N1CCN(C(=O)Cc2ccccc2)[C@@H](CN2CC[C@@H](O)C2)C1,54,8,46,0.14814814814814814,0.8518518518518519,1,4
CC(=O)N1CCN(C(=O)Cc2ccc([S@@](C)=O)cc2)[C@@H](CN2CC[C@H](O)C2)C1,59,10,49,0.1694915254237288,0.8305084745762712,1,5
CC(=O)N1CCN(C(=O)Cc2ccc(S(C)(=O)=O)cc2)[C@@H](CN2CC[C@H](O)C2)C1,60,10,50,0.16666666666666666,0.8333333333333334,1,6
CC(C)[C@@H](CN1CCCC1)N(C)C(=O)Cc1ccc(Cl)c(Cl)c1,50,10,40,0.2,0.8,0,2
CN(C(=O)Cc1ccc(Cl)c(Cl)c1)[C@@H](CN1CCCC1)c1ccccc1,52,8,44,0.15384615384615385,0.8461538461538461,0,2
Cc1cc(N/C(O)=C2\C(=O)c3ccccc3S(=O)(=O)N2C)no1,38,5,33,0.13157894736842105,0.868421052631579,2,7
C=CCN1CC[C@]23CCCC[C@H]2[C@H]1Cc1ccc(O)cc13,49,3,46,0.061224489795918366,0.9387755102040817,1,2
CCn1cc(C(=O)O)c(=O)c2cc(F)c(N3CCNC(C)C3)c(F)c21,46,6,40,0.13043478260869565,0.8695652173913043,2,6
CN(C)C(=O)C(CCN1CCC(O)(c2ccc(Cl)cc2)CC1)(c1ccccc1)c1ccccc1,70,11,59,0.15714285714285714,0.8428571428571429,1,3
CN(C)CCCN1c2ccccc2CCc2ccc(Cl)cc21,47,6,41,0.1276595744680851,0.8723404255319149,0,2
O=C1CN=C(c2ccccc2Cl)c2cc([N+](=O)[O-])ccc2N1,34,2,32,0.058823529411764705,0.9411764705882353,1,4
OCCN1CCN(CC/C=C2/c3ccccc3Sc3ccc(Cl)cc32)CC1,55,6,49,0.10909090909090909,0.8909090909090909,1,4
O=c1[nH]c2cc(Cl)ccc2n1C1CCN(CCCC(c2ccc(F)cc2)c2ccc(F)cc2)CC1,67,7,60,0.1044776119402985,0.8955223880597015,1,3
COC(=O)[C@@H]1C2CCC(C[C@@H]1OC(=O)c1ccccc1)N2C,45,7,38,0.15555555555555556,0.8444444444444444,0,5
COc1ccc2c3c1O[C@H]1[C@@H](O)C=C[C@H]4[C@@H](C2)N(C)CC[C@@]341,47,4,43,0.0851063829787234,0.9148936170212766,1,4
CC1C2Cc3ccc(O)cc3C1(C)CCN2CC1CC1,48,5,43,0.10416666666666667,0.8958333333333334,1,2
FC(F)(F)c1ccc2c(c1)N(CCCN1CCN(C3CC3)CC1)c1ccccc1S2,60,6,54,0.1,0.9,0,4
CN(C)CCO,16,5,11,0.3125,0.6875,1,2
CCOC(=O)C1(c2ccccc2)CCN(C)CC1.[Cl-].[H+],40,6,34,0.15,0.85,0,3
ClC=C(Cl)Cl,5,0,5,0.0,1.0,0,0
ClC(Cl)Cl,4,0,4,0.0,1.0,0,0
CNCCc1ccccn1,22,4,18,0.18181818181818182,0.8181818181818182,1,2
CN(C)CCc1ccccn1,25,5,20,0.2,0.8,0,2
NCCc1nccs1,16,3,13,0.1875,0.8125,1,3
NCCc1nc(-c2ccccc2)cs1,27,4,23,0.14814814814814814,0.8518518518518519,1,3
NCCc1cn2ccccc2n1,24,3,21,0.125,0.875,1,3
Cc1cccc(C)c1,18,2,16,0.1111111111111111,0.8888888888888888,0,0
CCOC(=O)N1CCC(=C2c3ccc(Cl)cc3CCc3cccnc32)CC1,53,4,49,0.07547169811320754,0.9245283018867925,0,3
Cc1cnc(N/C(O)=C2/C(=O)c3ccccc3S(=O)(=O)N2C)s1,38,5,33,0.13157894736842105,0.868421052631579,2,7
C=CCN1CC[C@]23c4c5ccc(O)c4O[C@H]2[C@@H](O)C=C[C@H]3[C@H]1C5,48,4,44,0.08333333333333333,0.9166666666666666,2,4
O=C1CC[C@@]2(O)[C@H]3Cc4ccc(O)c5c4[C@@]2(CCN3CC2CC2)[C@H]1O5,53,4,49,0.07547169811320754,0.9245283018867925,2,5
CCn1cc(C(=O)O)c(=O)c2cc(F)c(N3CCNCC3)cc21,43,5,38,0.11627906976744186,0.8837209302325582,2,6
CCn1cc(C(=O)O)c(=O)c2cc(F)c(N3CCN(C)CC3)cc21,46,6,40,0.13043478260869565,0.8695652173913043,1,6
CN1/C(=C(/O)Nc2ccccn2)C(=O)c2ccccc2S1(=O)=O,38,4,34,0.10526315789473684,0.8947368421052632,2,6
CS(=O)(=O)O.Oc1ccc2[nH]cc(CCCCN3CC=C(c4ccccc4)CC3)c2c1,63,9,54,0.14285714285714285,0.8571428571428571,3,5
COC(=O)[C@H]1[C@H]2C[C@@H]3c4[nH]c5ccccc5c4CCN3C[C@H]2C[C@@H](OC(=O)c2cc(OC)c(OC)c(OC)c2)[C@@H]1OC,85,14,71,0.16470588235294117,0.8352941176470589,1,9
CNCCCN1c2ccccc2CCc2ccccc21,44,5,39,0.11363636363636363,0.8863636363636364,1,2
CN1C(=O)CN=C(c2ccccc2)c2cc(Cl)ccc21,35,2,33,0.05714285714285714,0.9428571428571428,0,2
COc1ccc2c3c1O[C@H]1[C@@H](O)CC[C@H]4[C@@H](C2)N(C)CC[C@@]341,49,4,45,0.08163265306122448,0.9183673469387755,1,4
CN1CCC23c4c5ccc(O)c4OC2C(O)CCC3C1C5,46,3,43,0.06521739130434782,0.9347826086956522,2,4
CN(C)CCOC(c1ccccc1)c1ccccc1,41,8,33,0.1951219512195122,0.8048780487804879,0,2
O=C1NC(=O)C(c2ccccc2)(c2ccccc2)N1,33,2,31,0.06060606060606061,0.9393939393939394,2,2
CC(CN1CCN(CCOCCO)CC1)CN1c2ccccc2Sc2ccccc21,66,11,55,0.16666666666666666,0.8333333333333334,1,6
COC(=O)c1ccc(C(=O)OC)cc1,24,6,18,0.25,0.75,0,4
Cc1ccccc1C,18,2,16,0.1111111111111111,0.8888888888888888,0,0
Cc1ccc(C)cc1,18,2,16,0.1111111111111111,0.8888888888888888,0,0
CC(C)O,11,3,8,0.2727272727272727,0.7272727272727273,1,1
NC(=O)N1c2ccccc2C2OC2c2ccccc21,34,2,32,0.058823529411764705,0.9411764705882353,1,2
CC(C)(C)OC(=O)CCCc1ccc(N(CCCl)CCCl)cc1,50,14,36,0.28,0.72,0,3
CC(C)Nc1cccnc1N1CCN(C(=O)c2cc3cc(NS(C)(=O)=O)ccc3[nH]2)CC1,63,10,53,0.15873015873015872,0.8412698412698413,3,6
CC(C)(C)c1ccc(C(=O)CCCN2CCC(OC(c3ccccc3)c3ccccc3)CC2)cc1,77,13,64,0.16883116883116883,0.8311688311688312,0,3
CN1CCN(CC(=O)N2c3ccccc3C(=O)Nc3cccnc32)CC1,50,4,46,0.08,0.92,1,5
CCCNC(=O)c1ccc2c(c1)N([C@@H](C)CN1CCCC1)c1ccccc1S2,60,9,51,0.15,0.85,1,4
CN1CCN(c2c(F)cc3c(=O)c(C(=O)O)cn4c3c2SCC4)CC1,46,4,42,0.08695652173913043,0.9130434782608695,1,7
CC(C)(C)NCC(O)c1ccc(O)c(CO)c1,38,11,27,0.2894736842105263,0.7105263157894737,4,4
CN1CCN(C(=O)Cc2ccc(Cl)c(Cl)c2)[C@@H](CN2CCCC2)C1,51,6,45,0.11764705882352941,0.8823529411764706,0,3
O=C(Cc1ccc(Cl)c(Cl)c1)N1CCn2ccnc2[C@H]1CN1CCCC1,51,5,46,0.09803921568627451,0.9019607843137255,0,4
O=C1NC(=O)[C@@]2(CCN(C(=O)Cc3ccc(Cl)c(Cl)c3)[C@@H](CN3CCCC3)C2)N1,56,5,51,0.08928571428571429,0.9107142857142857,2,4
O=C(Cc1ccc(Cl)c(Cl)c1)N1CCn2ccnc2[C@H]1CN1CC[C@@H](O)C1,52,6,46,0.11538461538461539,0.8846153846153846,1,5
O=C(Cc1ccc(Cl)c(Cl)c1)N1CCn2ncnc2[C@H]1CN1CCCC1,50,5,45,0.1,0.9,0,5
O=C(Cc1ccc(Cl)c(Cl)c1)N1CCN(CCO)C[C@@H]1CN1CC[C@@H](O)C1,56,9,47,0.16071428571428573,0.8392857142857143,2,5
CN(C)CC/C=C1/c2ccccc2COc2ccccc21.[Cl-].[H+],44,5,39,0.11363636363636363,0.8863636363636364,0,2
CN(C)CCOC(C)(c1ccccc1)c1ccccn1.O=C(O)CCC(=O)O,56,14,42,0.25,0.75,2,7
O=C(CCCN1CC=C(n2c(=O)[nH]c3ccccc32)CC1)c1ccc(F)cc1,53,6,47,0.11320754716981132,0.8867924528301887,1,4
C/C=C(\CC)C(=O)NC(N)=O,22,7,15,0.3181818181818182,0.6818181818181818,2,2
CCC(C)(CC)OC(N)=O,24,8,16,0.3333333333333333,0.6666666666666666,1,2
Clc1ccc2c(c1)C(c1ccccc1)=NCc1nncn1-2,35,1,34,0.02857142857142857,0.9714285714285714,0,4
CCc1ccccc1-n1c(C)nc2ccccc2c1=O,38,4,34,0.10526315789473684,0.8947368421052632,0,3
CCOC(=O)c1cnc2c(cnn2CC)c1NN=C(C)C,41,10,31,0.24390243902439024,0.7560975609756098,1,7
C#CC(O)(/C=C/Cl)CC,17,4,13,0.23529411764705882,0.7647058823529411,1,1
C#CC1(OC(N)=O)CCCCC1,25,3,22,0.12,0.88,1,2
CNCCc1ccccn1,22,4,18,0.18181818181818182,0.8181818181818182,1,2
CN(C)CCc1ccccn1,25,5,20,0.2,0.8,0,2
NCCc1nccs1,16,3,13,0.1875,0.8125,1,3
S=C(NC1CCCCC1)N1CCC(c2c[nH]cn2)CC1,46,4,42,0.08695652173913043,0.9130434782608695,2,2
CN1CC[C@@H]2c3cc(Cl)ccc3Oc3ccccc3[C@H]2C1,42,1,41,0.023809523809523808,0.9761904761904762,0,2
O=C1CCCN1CCCCN1CCN(c2cc(C(F)(F)F)cc(Cl)n2)CC1,53,7,46,0.1320754716981132,0.8679245283018868,0,4
Clc1ccc2c(c1)[C@H]1CCNC[C@@H]1c1ccccc1O2,39,0,39,0.0,1.0,1,2
O=C(Cc1ccc(Cl)c(Cl)c1)N1CCc2[nH]cnc2[C@H]1CN1CC[C@@H](O)C1,52,6,46,0.11538461538461539,0.8846153846153846,2,4
CC[C@H](NC(=O)c1c(O)c(-c2ccccc2)nc2ccccc12)c1ccccc1,54,8,46,0.14814814814814814,0.8518518518518519,2,3
CC[C@H](NC(=O)c1c(OCCCN(C)C)c(-c2ccccc2)nc2ccccc12)c1ccccc1,71,14,57,0.19718309859154928,0.8028169014084507,1,4
CC[C@H](NC(=O)c1c(OCC(=O)O)c(-c2ccccc2)nc2ccccc12)c1ccccc1,60,11,49,0.18333333333333332,0.8166666666666667,2,5
CC[C@H](NC(=O)c1c(OCCCC(=O)O)c(-c2ccccc2)nc2ccccc12)c1ccccc1,66,13,53,0.19696969696969696,0.803030303030303,2,5
CC[C@H](NC(=O)c1c(OCCNC(=O)Cc2ccccc2C(=O)O)c(-c2ccccc2)nc2ccccc12)c1ccccc1,81,16,65,0.19753086419753085,0.8024691358024691,3,6
CC[C@H](NC(=O)c1c(OCCNC(=O)Cc2ccccn2)c(-c2ccccc2)nc2ccccc12)c1ccccc1,77,14,63,0.18181818181818182,0.8181818181818182,2,5
CC[C@H](NC(=O)c1c(OCCNC(=O)[C@@H]2CCCN2)c(-c2ccccc2)nc2ccccc12)c1ccccc1,77,13,64,0.16883116883116883,0.8311688311688312,3,5
CC[C@H](NC(=O)c1c(Cn2ccnc2)c(-c2ccccc2)nc2ccccc12)c1ccccc1,64,9,55,0.140625,0.859375,1,4
C[C@@H]1CN(c2c(F)c(N)c3c(=O)c(C(=O)O)cn(C4CC4)c3c2F)C[C@H](C)N1,53,7,46,0.1320754716981132,0.8679245283018868,3,7
CCC1(C)CC(=O)NC1=O,21,3,18,0.14285714285714285,0.8571428571428571,1,2
CCc1ccc2c(c1)N(CC(C)CN(C)C)c1ccccc1S2,51,9,42,0.17647058823529413,0.8235294117647058,0,3
OCCN1CCN(CC/C=C2/c3ccccc3Sc3ccc(C(F)(F)F)cc32)CC1,58,7,51,0.1206896551724138,0.8793103448275862,1,4
OCCN1CCN(CCCN2c3ccccc3Sc3ccc(C(F)(F)F)cc32)CC1,59,8,51,0.13559322033898305,0.864406779661017,1,5
CCN(CC)CCN1C(=O)CN=C(c2ccccc2F)c2cc(Cl)ccc21,52,8,44,0.15384615384615385,0.8461538461538461,0,3
COc1cc2c3c(c1O)C1(C=CC(=O)C=C1)CC3N(C)CC2,44,4,40,0.09090909090909091,0.9090909090909091,1,4
CCC1(c2ccccc2)CCC(=O)NC1=O,32,3,29,0.09375,0.90625,1,2
O=C(CCCN1CCC(O)(c2ccc(Cl)cc2)CC1)c1ccc(F)cc1,51,7,44,0.13725490196078433,0.8627450980392157,1,3
Cc1[nH]ccc2c1[nH]c1cc(=O)ccc12,27,1,26,0.037037037037037035,0.9629629629629629,2,1
Cc1nccc2c1[nH]c1ccccc12,26,1,25,0.038461538461538464,0.9615384615384616,1,1
O=[N+]([O-])c1cc[nH]c1NCCSCc1ccccn1,34,7,27,0.20588235294117646,0.7941176470588235,2,5
Cc1cc(C(C)(C)SC(C)(C)CNc2[nH]ccc2[N+](=O)[O-])nc(C)c1C,55,14,41,0.2545454545454545,0.7454545454545455,2,5
C[NH+]O.Cc1oc(C(C)(C)N(C(C)(C)N)C(C)(C)N)c(C)c1C.[OH-],59,17,42,0.288135593220339,0.711864406779661,4,7
Cc1c[nH+][o+]c(C([NH])CC(C)C(C)(C)N(C(C)(C)C)C(C)(N)N)c1[O-],60,18,42,0.3,0.7,2,4
CCNCc1c(CSC)cnc(C)c1O,33,9,24,0.2727272727272727,0.7272727272727273,2,4
CN1/C(=C(\O)Nc2ccccn2)C(=O)c2sccc2S1(=O)=O,35,4,31,0.11428571428571428,0.8857142857142857,2,7
CC(C)(C)c1ccc(C(O)CCCN2CCC(C(O)(c3ccccc3)c3ccccc3)CC2)cc1,79,14,65,0.17721518987341772,0.8227848101265823,2,3
CN(C(=O)Cc1ccc(Cl)c(Cl)c1)C1CCCC[C@H]1N1CCCC1,52,6,46,0.11538461538461539,0.8846153846153846,0,2
CC(=O)Oc1ccc2c3c1O[C@H]1[C@@H](OC(C)=O)C=C[C@H]4[C@@H](C2)N(C)CC[C@@]341,54,7,47,0.12962962962962962,0.8703703703703703,0,6
C#CCC1(OC(N)=O)CCCCC1,28,4,24,0.14285714285714285,0.8571428571428571,1,2
OCCN1CCCN(CCCN2c3ccccc3Sc3cc(C(F)(F)F)ccc32)CC1.[Cl-].[Cl-].[H+].[H+],62,8,54,0.12903225806451613,0.8709677419354839,1,5
COc1ccc2c3c1O[C@H]1C(=O)CC[C@H]4[C@@H](C2)N(C)CC[C@]314,47,3,44,0.06382978723404255,0.9361702127659575,0,4
CCC(O)(COC(N)=O)c1ccccc1,30,8,22,0.26666666666666666,0.7333333333333333,2,3
OCCOCCN1CCN(C(c2ccccc2)c2ccc(Cl)cc2)CC1,55,9,46,0.16363636363636364,0.8363636363636363,1,4
CN(C)CCCN1c2ccccc2CCc2ccccc21,47,6,41,0.1276595744680851,0.8723404255319149,0,2
CNC1(c2ccccc2Cl)CCCCC1=O,33,3,30,0.09090909090909091,0.9090909090909091,1,2
O=C(O)c1cc(=O)c2ccccc2[nH]1,22,2,20,0.09090909090909091,0.9090909090909091,2,3
O=C(NCCCOc1cccc(CN2CCCCC2)c1)c1ccccc1,56,9,47,0.16071428571428573,0.8392857142857143,1,3
OCCCOc1cccc(CN2CCCCC2)c1,42,7,35,0.16666666666666666,0.8333333333333334,1,3
c1ccc(NCCCOc2cccc(CN3CCCCC3)c2)nc1,53,8,45,0.1509433962264151,0.8490566037735849,1,4
c1cc(CN2CCCCC2)cc(OCCCNc2nccs2)c1,50,8,42,0.16,0.84,1,5
c1cc(CN2CCCCC2)cc(OCCCNc2nc3ccccc3o2)c1,57,8,49,0.14035087719298245,0.8596491228070176,1,5
CN(C)Cc1ccc(CSCCNc2nc(=O)c(Cc3ccc4ccccc4c3)c[nH]2)o1,63,12,51,0.19047619047619047,0.8095238095238095,2,6
Cc1ccc(CC2=CNC(NCCSCc3ccc(CN(C)C)o3)=NC2)cn1,59,13,46,0.22033898305084745,0.7796610169491526,2,7
CN(C)c1cc(-c2n[nH]c(N)n2)ccn1,28,5,23,0.17857142857142858,0.8214285714285714,2,5
Cn1c(=O)c2nc[nH]c2n(C)c1=O,22,2,20,0.09090909090909091,0.9090909090909091,1,5
O=C(CCCN1CCC(C(=O)c2ccc(F)cc2)CC1)c1ccc(F)cc1,52,7,45,0.1346153846153846,0.8653846153846154,0,3
CN1CC[C@]23CCCC[C@H]2[C@H]1Cc1ccc(O)cc13,45,2,43,0.044444444444444446,0.9555555555555556,1,2
CCN(CC)CC(=O)Nc1c(C)cccc1C,39,10,29,0.2564102564102564,0.7435897435897436,1,2
O=C1Nc2ccc(Cl)cc2C(c2ccccc2Cl)=NC1O,33,2,31,0.06060606060606061,0.9393939393939394,2,3
CC(C)N1CCC(N(C(=O)Cc2ccccc2)c2ccc(Cl)cc2)CC1,55,8,47,0.14545454545454545,0.8545454545454545,0,2
CN(C)CCOC(=O)COc1ccc(Cl)cc1,33,9,24,0.2727272727272727,0.7272727272727273,0,4
Cc1nc2ccccc2c(=O)n1-c1ccccc1Cl,32,2,30,0.0625,0.9375,0,3
CN1CCN=C(c2ccccc2)c2cc(Cl)ccc21,36,2,34,0.05555555555555555,0.9444444444444444,0,2
CCCC(C)(COC(N)=O)COC(N)=O,32,12,20,0.375,0.625,2,4
COc1cc2c(c(CN[C@@H]3CCCN[C@H]3c3ccccc3)c1)OCC2,54,6,48,0.1111111111111111,0.8888888888888888,2,4
NCCn1ncc2cc(Cl)c(Cl)cc21,24,3,21,0.125,0.875,1,3
Nc1nc(NC2CC2)c2ncn([C@H]3C=C[C@@H](CO)C3)c2n1,42,6,36,0.14285714285714285,0.8571428571428571,3,7
CCCC(=O)Nc1ccc(OCC(O)CNC(C)C)c(C(C)=O)c1,52,16,36,0.3076923076923077,0.6923076923076923,3,5
Nc1nc(=O)c2ncn(COCCO)c2[nH]1,28,6,22,0.21428571428571427,0.7857142857142857,3,7
CCCSc1ccc2nc(NC(=O)OC)[nH]c2c1,34,8,26,0.23529411764705882,0.7647058823529411,2,4
NCCCNCCSP(=O)(O)O,26,10,16,0.38461538461538464,0.6153846153846154,4,6
COc1cc(CCN)cc(OC)c1OC,32,9,23,0.28125,0.71875,1,4
CN1CCCCC1CCN1c2ccccc2Sc2ccc(S(C)=O)cc21,55,6,49,0.10909090909090909,0.8909090909090909,0,4
CN[C@@H](C)Cc1ccccc1,26,5,21,0.19230769230769232,0.8076923076923077,1,1
Cc1ccccc1-n1c(C)nc2ccccc2c1=O,35,3,32,0.08571428571428572,0.9142857142857143,0,3
COc1ccccc1OCC(O)COC(N)=O,32,10,22,0.3125,0.6875,2,5
COc1ccc2c(c1)N(CCCN(C)C)c1ccccc1S2,46,8,38,0.17391304347826086,0.8260869565217391,0,4
COc1ccc2c(c1)N(C[C@H](C)CN(C)C)c1ccccc1S2,49,9,40,0.1836734693877551,0.8163265306122449,0,4
C#CC(C)(O)CC,16,4,12,0.25,0.75,1,1
COC(=O)C(c1ccccc1)C1CCCCN1,37,5,32,0.13513513513513514,0.8648648648648649,1,3
CCC1(CC)C(=O)NCC(C)C1=O,30,5,25,0.16666666666666666,0.8333333333333334,1,2
NCC[C@H](O)C(=O)N[C@@H]1C[C@H](N)[C@@H](O[C@H]2O[C@H](CN)[C@@H](O)[C@H](O)[C@H]2O)[C@H](O)[C@H]1O[C@H]1O[C@H](CO)[C@@H](O)[C@H](N)[C@H]1O,85,23,62,0.27058823529411763,0.7294117647058823,13,17
Nc1ccc(C(=O)O)c(O)c1,18,4,14,0.2222222222222222,0.7777777777777778,3,4
Nc1ccn([C@@H]2O[C@H](CO)[C@@H](O)[C@@H]2O)c(=O)n1,31,6,25,0.1935483870967742,0.8064516129032258,4,8
CN(C)N/N=C1/N=CN=C1C(N)=O,23,6,17,0.2608695652173913,0.7391304347826086,2,5
COc1cccc2c1C(=O)c1c(O)c3c(c(O)c1C2=O)C[C@@](O)(C(C)=O)C[C@@H]3O[C@H]1C[C@H](N)[C@H](O)[C@H](C)O1,71,12,59,0.16901408450704225,0.8309859154929577,5,11
CN(C)[C@@H]1C(=O)/C(=C(\N)O)C(=O)[C@@]2(O)C(=O)C3=C(O)c4c(O)ccc(Cl)c4[C@@H](O)[C@H]3C[C@@H]12,56,9,47,0.16071428571428573,0.8392857142857143,6,10
O=C1CC(=O)N(c2ccccc2)c2cc(Cl)ccc2N1,33,1,32,0.030303030303030304,0.9696969696969697,1,2
CNCCCN1c2ccccc2Sc2ccccc21,39,5,34,0.1282051282051282,0.8717948717948718,1,3
C[C@@H](CN1CC(=O)NC(=O)C1)N1CC(=O)NC(=O)C1,36,4,32,0.1111111111111111,0.8888888888888888,2,6
Cc1ncc2n1-c1ccc(Cl)cc1C(c1ccccc1F)=NC2.O=C(O)/C=C\C(=O)O,50,6,44,0.12,0.88,2,7
Cc1ccc(C2(O)CCN(CCCC(=O)c3ccc(F)cc3)CC2)cc1,54,8,46,0.14814814814814814,0.8518518518518519,1,3
CN1CC[C@]23c4c5ccc(O)c4O[C@H]2C(O)C=C[C@H]3[C@H]1C5,44,3,41,0.06818181818181818,0.9318181818181818,2,4
CN1CC=C(c2ccccc2)CC1,29,2,27,0.06896551724137931,0.9310344827586207,0,1
C=CCN1CC[C@]23c4c5ccc(O)c4O[C@H]2C(=O)CC[C@@]3(O)[C@H]1C5,49,4,45,0.08163265306122448,0.9183673469387755,2,5
CN1CCC[C@H]1c1cccnc1,27,2,25,0.07407407407407407,0.9259259259259259,0,2
O=C1CN=C(c2ccccc2)c2cc([N+](=O)[O-])ccc2N1,34,2,32,0.058823529411764705,0.9411764705882353,1,4
O=C1CN=C(c2ccccc2)c2cc(Cl)ccc2N1,32,1,31,0.03125,0.96875,1,2
CNCCC=C1c2ccccc2CCc2ccccc21,43,4,39,0.09302325581395349,0.9069767441860465,1,1
Cc1ccccc1C(OCCN(C)C)c1ccccc1,44,9,35,0.20454545454545456,0.7954545454545454,0,2
COc1ccc2c(c1)[C@]13CCCC[C@@H]1[C@H](C2)N(C)CC3,48,3,45,0.0625,0.9375,0,2
CN1C[C@H](C(=O)N[C@]2(C)O[C@@]3(O)[C@@H]4CCCN4C(=O)[C@H](Cc4ccccc4)N3C2=O)C[C@@H]2c3cccc4[nH]cc(c34)C[C@H]21,87,8,79,0.09195402298850575,0.9080459770114943,3,6
CCN(CC)C(=S)SSC(=S)N(CC)CC,35,13,22,0.37142857142857144,0.6285714285714286,0,4
O=C1Nc2ccc(Cl)cc2[C@@](C#CC2CC2)(C(F)(F)F)O1,32,1,31,0.03125,0.96875,1,2
CCOC(=O)[C@H](CCc1ccccc1)N[C@@H](C)C(=O)N1CCC[C@H]1C(=O)O,56,14,42,0.25,0.75,2,6
CC[C@@H](CO)NCCN[C@@H](CC)CO,37,13,24,0.35135135135135137,0.6486486486486487,4,4
CC[C@@]1(O)C[C@H](OC2CC(N(C)C)C(OC3CC(O)C(OC4CCC(=O)C(C)O4)C(C)O3)C(C)O2)c2c(cc3c(c2O)C(=O)c2c(O)cccc2C3=O)[C@H]1C(=O)OC,117,21,96,0.1794871794871795,0.8205128205128205,4,16
CC1(C)S[C@@H]2[C@H](NC(=O)CCC[C@@H](N)C(=O)O)C(=O)N2[C@H]1C(=O)O,46,13,33,0.2826086956521739,0.717391304347826,4,8
CNCC(O)c1ccc(O)c(O)c1,26,7,19,0.2692307692307692,0.7307692307692307,4,4
COc1cccc2c1C(=O)c1c(O)c3c(c(O)c1C2=O)CC(O)(C(=O)CO)CC3O,51,9,42,0.17647058823529413,0.8235294117647058,5,9
C=CCSCC(=O)NC1C(=O)N2C1SC(C)(C)C2C(=O)[O-].[Na+],39,9,30,0.23076923076923078,0.7692307692307693,1,6
CC1(C)S[C@@H]2[C@H](NC(=O)C34C[C@@H]5C[C@@H](CC(N)(C5)C3)C4)C(=O)N2[C@H]1C(=O)O,58,8,50,0.13793103448275862,0.8620689655172413,3,6
CC(C)(C)C(=O)OCOC(=O)C1N2C(=O)[C@@H](N=CN3CCCCCC3)[C@H]2SC1(C)C,65,13,52,0.2,0.8,0,7
CN(C)[C@@H]1C(=O)/C(=C(\N)O)C(=O)[C@@]2(O)C(=O)C3=C(O)c4c(ccc(N)c4O)C[C@H]3C[C@@H]12,57,9,48,0.15789473684210525,0.8421052631578947,6,10
CC(=O)[C@]1(N)Cc2c(O)c3c(c(O)c2[C@@H](O[C@H]2C[C@H](O)[C@H](O)CO2)C1)C(=O)c1ccccc1C3=O.[Cl-].[H+],64,9,55,0.140625,0.859375,5,10
CC1(C)S[C@@H]2C(NC(=O)[C@H](NC(=O)c3c[nH]c4cccnc4c3=O)c3ccccc3)C(=O)N2[C@H]1C(=O)O,64,11,53,0.171875,0.828125,4,8
CN(C)[C@@H]1C(=O)/C(=C(/O)NC(C(=O)O)N2CCN(CCO)CC2)C(=O)[C@@]2(O)C(=O)C3=C(O)c4c(O)cccc4[C@@](C)(O)[C@H]3C[C@@H]12,87,17,70,0.19540229885057472,0.8045977011494253,8,15
CN[C@@H]1[C@@H](O[C@H]2O[C@H](CO)[C@@H](N)[C@H](O)[C@H]2O)O[C@H]2C[C@@H](N)[C@H](O[C@H]3[C@H](O)[C@@H](O)[C@H](N)C[C@@H]3N)O[C@@H]2[C@@H]1O,81,17,64,0.20987654320987653,0.7901234567901234,11,16
NCC[C@H](O)C(=O)N[C@@H]1C[C@H](N)[C@@H](O[C@H]2O[C@H](CN)CC[C@H]2N)[C@H](O)[C@H]1O[C@H]1O[C@H](CO)[C@@H](O)[C@H](N)[C@H]1O,84,21,63,0.25,0.75,11,15
CNC(=O)C[C@@H](N)C(=O)N[C@@H](C(=O)N[C@@H]1C(=O)N2[C@@H]1SC(C)(C)[C@@H]2C(=O)O)c1ccc(O)cc1,63,17,46,0.2698412698412698,0.7301587301587301,6,9
CO[C@H]1[C@@H](O)[C@H](N)[C@@H](O[C@H]2O[C@H](C(C)N)CC[C@H]2N)[C@H](O)[C@@H]1N(C)C(=O)CN,64,16,48,0.25,0.75,6,10
C[C@H]1[C@H](NC(=O)/C(=N\OC(C)(C)C(=O)O)c2csc([NH3+])n2)C(=O)N1S(=O)(=O)[O-],46,13,33,0.2826086956521739,0.717391304347826,3,11
CCOC(=O)OC(C)OC(=O)[C@@H]1N2C(=O)[C@@H](N=CN3CCCCCC3)[C@H]2SC1(C)C,63,13,50,0.20634920634920634,0.7936507936507936,0,8
NCC1OC(OC2C(N)CC(N)C(OC3OC(CO)C(O)C(N)C3O)C2O)C(N)C(O)C1O,72,17,55,0.2361111111111111,0.7638888888888888,11,15
NC(CO)C(=O)NNCc1ccc(O)c(O)c1O,33,11,22,0.3333333333333333,0.6666666666666666,7,7
CC(C)COCC(CN(Cc1ccccc1)c1ccccc1)N1CCCC1,63,12,51,0.19047619047619047,0.8095238095238095,0,3
CC[C@H]1OC(=O)[C@H](C)[C@@H](OC2CC(C)(OC)C(O)C(C)O2)C(C)[C@@H](OC2OC(C)CC(N(C)C)C2O)[C@](C)(O)C[C@@H](C)C(=O)[C@H](C)[C@@H](O)[C@H]1C,119,24,95,0.20168067226890757,0.7983193277310925,4,13
NCCC(O)CNC1CC(N)C(OC2OC(CN)C(O)C(O)C2O)C(O)C1OC1OC(CO)C(O)C(N)C1O,86,23,63,0.26744186046511625,0.7325581395348837,13,17
CC(C)(C)NCC(O)c1ccc(O)c(NC(N)=O)c1,40,12,28,0.3,0.7,5,4
CC1(C)S[C@@H]2[C@H](NC(=O)C(C(=O)Oc3ccccc3)c3ccccc3)C(=O)N2[C@H]1C(=O)O,57,11,46,0.19298245614035087,0.8070175438596491,2,7
CC1(C)S[C@@H]2[C@H](NC(=O)C(C(=O)Oc3ccc4c(c3)CCC4)c3ccccc3)C(=O)N2[C@H]1C(=O)O,65,11,54,0.16923076923076924,0.8307692307692308,2,7
CC(=O)[C@]1(O)Cc2c(O)c3c(c(O)c2C(OC2CC(N)C(O)C(C)O2)C1)C(=O)c1c(O)cccc1C3=O,68,11,57,0.16176470588235295,0.8382352941176471,6,11
NC(=O)OCC1[C@H](NC(=O)/C(=N\OCC(=O)O)c2csc(N)n2)C(=O)N1S(=O)(=O)O,45,15,30,0.3333333333333333,0.6666666666666666,5,14
N[C@@H](C(=O)N[C@@H]1C(=O)N2C(C(=O)O)=C(Cl)CS[C@H]12)c1ccccc1,40,7,33,0.175,0.825,3,6
CC1=C(C(=O)O)N2C(=O)[C@@H](NC(=O)[C@H](N)c3ccc(O)cc3)[C@H]2SC1,44,9,35,0.20454545454545456,0.7954545454545454,4,7
CC1=C(C(=O)O)N2C(=O)[C@@H](NC(=O)[C@H](N)c3ccccc3)[C@H]2SC1,43,8,35,0.18604651162790697,0.813953488372093,3,6
CC(=O)OCC1=C(C(=O)O)N2C(=O)[C@@H](NC(=O)Cc3ccccc3)[C@H]2SC1,47,10,37,0.2127659574468085,0.7872340425531915,2,7
Cc1nnc(SCC2=C(C(=O)O)N3C(=O)[C@@H](NC(=O)C(N)c4ccc(O)cc4)[C@H]3SC2)s1,54,12,42,0.2222222222222222,0.7777777777777778,4,11
NC(C(=O)N[C@@H]1C(=O)N2C(C(=O)O)=C(CSc3cn[nH]n3)CS[C@H]12)c1ccc(O)cc1,52,11,41,0.21153846153846154,0.7884615384615384,5,10
Cn1nnnc1SCC1=C(C(=O)[O-])N2C(=O)[C@@H](NC(=O)CSC(F)(F)F)[C@H]2SC1.[Na+],43,10,33,0.23255813953488372,0.7674418604651163,1,11
Cc1nnc(SCC2=C(C(=O)O)N3C(=O)[C@@H](NC(=O)Cn4cc(Cl)c(=O)c(Cl)c4)[C@H]3SC2)s1,51,10,41,0.19607843137254902,0.803921568627451,2,11
Cc1nnc(SCC2=C(C(=O)O)N3C(=O)[C@@H](NC(=O)[C@H](O)c4ccccc4)[C@H]3SC2)s1,52,11,41,0.21153846153846154,0.7884615384615384,3,10
Cc1nnc(SCC2=C(C(=O)OCc3oc(=O)oc3C)N3C(=O)C(NC(=O)C(OC(=O)C(C)N)c4ccccc4)C3SC2)s1,75,18,57,0.24,0.76,2,15
CC/C=C(\C(=O)N[C@@H]1C(=O)N2C(C(=O)O)=C(COC(N)=O)CS[C@H]12)c1csc(N)n1,51,13,38,0.2549019607843137,0.7450980392156863,4,10
COCC1=C(C(=O)O)N2C(=O)[C@@H](NC(=O)/C(=N\O)c3csc(N)n3)[C@H]2SC1,44,11,33,0.25,0.75,4,11
C=CC1=C(C(=O)O)N2C(=O)[C@@H](NC(=O)/C(=N\O)c3csc(N)n3)[C@H]2SC1,41,9,32,0.21951219512195122,0.7804878048780488,4,10
CO/N=C(\C(=O)NC1C(=O)N2C(C(=O)O)=C(/C=C\c3scnc3C)CS[C@H]12)c1csc(N)n1,54,12,42,0.2222222222222222,0.7777777777777778,3,12
CC1=C(C(=O)O)N2C(=O)[C@@H](NC(=O)[C@H](N)c3ccc(O)c(Cl)c3)[C@H]2SC1,44,9,35,0.20454545454545456,0.7954545454545454,4,7
CO/N=C(\C(=O)N[C@@H]1C(=O)N2C(C(=O)O)=C(C)CS[C@H]12)c1csc(N)n1,43,10,33,0.23255813953488372,0.7674418604651163,3,10
O=C(Cc1cccs1)N[C@@H]1C(=O)N2C(C(=O)O)=C(CSc3ncn[nH]3)CS[C@H]12,46,9,37,0.1956521739130435,0.8043478260869565,3,9
Cn1nnnc1SCC1=C(C(=O)O)N2C(=O)[C@@H](NC(=O)CS/C=C\C#N)[C@H]2SC1,46,11,35,0.2391304347826087,0.7608695652173914,2,12
C=CC1=C(C(=O)O)N2C(=O)[C@@H](NC(=O)/C(=N\OCC(=O)O)c3csc(N)n3)[C@H]2SC1,47,12,35,0.2553191489361702,0.7446808510638298,4,12
CO/N=C(\C(=O)N[C@@H]1C(=O)N2C(C(=O)O)=C(CSc3nnnn3C)CS[C@H]12)c1csc(N)n1,53,13,40,0.24528301886792453,0.7547169811320755,3,15
CO[C@@]1(NC(=O)CSCC#N)C(=O)N2C(C(=O)O)=C(CSc3nnnn3C)CS[C@@H]21,49,13,36,0.2653061224489796,0.7346938775510204,2,13
CO[C@@]1(NC(=O)CSC[C@@H](N)C(=O)O)C(=O)N2C(C(=O)O)=C(CSc3nnnn3C)CS[C@@H]21,56,17,39,0.30357142857142855,0.6964285714285714,4,15
CO/N=C(/C(=O)N[C@@H]1C(=O)N2C(C(=O)O)=C(CSc3nc(C)c(CC(=O)O)s3)CS[C@H]12)c1csc(N)n1,60,16,44,0.26666666666666666,0.7333333333333333,4,15
O=C(O)C1=C(CSc2nnnn2CS(=O)(=O)O)CS[C@@H]2[C@H](NC(=O)C(O)c3ccccc3)C(=O)N12,56,13,43,0.23214285714285715,0.7678571428571429,4,14
NCc1ccccc1CC(=O)N[C@@H]1C(=O)N2C(C(=O)O)=C(CSc3nnnn3CC(=O)O)CS[C@H]12,59,14,45,0.23728813559322035,0.7627118644067796,4,13
CO[C@@]1(NC(=O)C2SC(=C(C(N)=O)C(=O)O)S2)C(=O)N2C(C(=O)O)=C(CSc3nnnn3C)CS[C@@H]21,56,15,41,0.26785714285714285,0.7321428571428571,4,16
CN(C)CCn1nnnc1SCC1=C(C(=O)O)N2C(=O)[C@@H](NC(=O)Cc3csc(N)n3)[C@H]2SC1,60,15,45,0.25,0.75,3,14
CC(=O)OCC1=C(C(=O)O)N2C(=O)[C@@H](NC(=O)c3c(-c4ccccc4Cl)noc3C)[C@H]2SC1,54,11,43,0.2037037037037037,0.7962962962962963,2,9
Cc1cc(=O)c(C(=O)N[C@@H](C(=O)NC2C(=O)N3C(C(=O)O)=C(CSc4nnnn4C)CS[C@H]23)c2ccc(O)cc2)c[nH]1,70,15,55,0.21428571428571427,0.7857142857142857,5,13
COCC1=C(C(=O)[O-])N2C(=O)[C@@H](NC(=O)/C(=N\OC)c3csc(N)n3)[C@H]2SC1.[Na+],46,11,35,0.2391304347826087,0.7608695652173914,2,11
C/C=C/C1=C(C(=O)O)N2C(=O)[C@@H](NC(=O)[C@H](N)c3ccc(O)cc3)[C@H]2SC1.O,50,10,40,0.2,0.8,4,7
CC1=C(C(=O)O)N2C(=O)[C@@H](NC(=O)Cc3ccc(C4=NCCCN4)cc3)[C@H]2SC1,54,8,46,0.14814814814814814,0.8518518518518519,3,7
COC1=C(C(=O)O)N2C(=O)C(NC(=O)C(N)C3C=CCC=C3)C2SC1,46,9,37,0.1956521739130435,0.8043478260869565,3,7
CC1=C(C(=O)O)N2C(=O)[C@@H](NC(=O)[C@H](N)c3cccc(NS(C)(=O)=O)c3)[C@H]2SC1,51,11,40,0.21568627450980393,0.7843137254901961,4,8
CO/N=C(\C(=O)N[C@@H]1C(=O)N2C(C(=O)O)=C(Cn3nnc(C)n3)CS[C@H]12)c1csc(N)n1,52,12,40,0.23076923076923078,0.7692307692307693,3,14
O=C(Cn1cnnn1)N[C@@H]1C(=O)N2C(C(=O)O)=C(CSc3nncs3)CS[C@H]12,43,9,34,0.20930232558139536,0.7906976744186046,2,13
Nc1nc(/C(=C/CC(=O)O)C(=O)N[C@@H]2C(=O)N3C(C(=O)O)=CCS[C@H]23)cs1.O.O,47,10,37,0.2127659574468085,0.7872340425531915,4,10
CO/N=C(\C(=O)N[C@@H]1C(=O)N2C(C(=O)O)=C(CSC(=O)c3ccco3)CS[C@H]12)c1csc(N)n1,54,13,41,0.24074074074074073,0.7592592592592593,3,13
CO/N=C(\C(=O)N[C@@H]1C(=O)N2C(C(=O)O)=C(/C=C/Sc3n[nH]c(=O)c(=O)n3CC=O)CS[C@H]12)c1csc(N)n1,60,14,46,0.23333333333333334,0.7666666666666667,4,16
CO/N=C(\C(=O)N[C@@H]1C(=O)N2C(C(=O)O)=C(COC(C)=O)CS(=O)[C@H]12)c1csc(N)n1,50,13,37,0.26,0.74,3,12
CO/N=C(\C(=O)N[C@@H]1C(=O)N2C(C(=O)O)=CCS[C@H]12)c1csc(N)n1,40,9,31,0.225,0.775,3,10
CO/N=C(\C(=O)N[C@@H]1C(=O)N2C(C(=O)O)=C(COC(C)=O)CS[C@H]12)c1ccco1,48,12,36,0.25,0.75,2,10
CO/N=C(\C(=O)N[C@@H]1C(=O)N2C(C(=O)OC(C)OC(C)=O)=C(COC(N)=O)CS[C@H]12)c1ccco1,59,17,42,0.288135593220339,0.711864406779661,2,12
COCCCC(=O)OC(C)OC(=O)C1=C(COC(N)=O)CS[C@@H]2[C@H](NC(=O)/C(=N\OC)c3ccco3)C(=O)N12,69,21,48,0.30434782608695654,0.6956521739130435,2,13
CO/N=C(\C(=O)N[C@@H]1C(=O)N2C(C(=O)O)=C(CSc3cnns3)CS[C@H]12)c1csc(N)n1,50,12,38,0.24,0.76,3,14
CC(=O)OCC1=C(C(=O)[O-])N2C(=O)[C@H](NC(=O)CC#N)[C@@H]2SC1.[Na+],36,8,28,0.2222222222222222,0.7777777777777778,1,8
CC(=O)OCC1=C(C(=O)O)N2C(=O)[C@@H](NC(=O)[C@H](N)c3ccccc3)[C@H]2SC1.O.O,53,11,42,0.20754716981132076,0.7924528301886793,3,8
CC(=O)OCC1=C(C(=O)O)N2C(=O)[C@@H](NC(=O)CCC[C@@H](N)C(=O)O)[C@H]2SC1,50,15,35,0.3,0.7,4,10
CC(=O)OCC1=C(C(=O)O)N2C(=O)[C@@H](NC(=O)Cc3cccs3)[C@H]2SC1,44,10,34,0.22727272727272727,0.7727272727272727,2,8
CC(=O)C1=C(O)[C@@]2(O)C(=O)c3c(c(C)c4ccc(C)c(O)c4c3O)C[C@H]2[C@@H](N)C1=O,54,9,45,0.16666666666666666,0.8333333333333334,5,8
CC[C@H]1OC(=O)[C@H](C)[C@@H](O[C@H]2C[C@@](C)(OC)[C@@H](O)[C@H](C)O2)[C@H](C)[C@@H](O[C@@H]2O[C@H](C)C[C@H](N(C)C)[C@H]2O)[C@](C)(OC)C[C@@H](C)C(=O)[C@H](C)[C@@H](O)[C@]1(C)O,123,26,97,0.21138211382113822,0.7886178861788617,4,14
CCC[C@@H]1C[C@@H](C(=O)NC(C(C)Cl)[C@H]2O[C@H](SC)[C@H](O)[C@@H](O)[C@H]2O)N(C)C1,61,15,46,0.2459016393442623,0.7540983606557377,4,7
CCC[C@@H]1C[C@@H](C(=O)NC(C(C)Cl)[C@H]2O[C@H](SC)[C@H](OP(=O)(O)O)[C@@H](O)[C@H]2O)N(C)C1,66,18,48,0.2727272727272727,0.7272727272727273,5,10
COC(C(=O)N[C@@H]1C(=O)N2[C@@H]1SC(C)(C)[C@@H]2C(=O)O)c1ccc(Cl)c(Cl)c1,47,10,37,0.2127659574468085,0.7872340425531915,2,6
CN(C)[C@@H]1C(=O)/C(=C(/O)NCO)C(=O)[C@@]2(O)C(=O)C3=C(O)c4c(O)ccc(Cl)c4[C@@](C)(O)[C@H]3C[C@@H]12,63,12,51,0.19047619047619047,0.8095238095238095,7,11
CC1(C)S[C@@H]2[C@H](NC(=O)C3(N)CCCCC3)C(=O)N2[C@H]1C(=O)O,48,8,40,0.16666666666666666,0.8333333333333334,3,6
CC=CCC(C)C(O)C1C(=O)NC(CC)C(=O)N(C)CC(=O)N(C)C(CC(C)C)C(=O)NC(C(C)C)C(=O)N(C)C(CC(C)C)C(=O)NC(C)C(=O)NC(C)C(=O)N(C)C(CC(C)C)C(=O)N(C)C(CC(C)C)C(=O)N(C)C(C(C)C)C(=O)N1C,196,40,156,0.20408163265306123,0.7959183673469388,5,12
Cc1c2oc3c(C)ccc(C(=O)NC4C(=O)NC(C(C)C)C(=O)N5CCCC5C(=O)N(C)CC(=O)N(C)C(C(C)C)C(=O)OC4C)c3nc-2c(C(=O)NC2C(=O)NC(C(C)C)C(=O)N3CCCC3C(=O)N(C)CC(=O)N(C)C(C(C)C)C(=O)OC2C)c(N)c1=O,182,27,155,0.14835164835164835,0.8516483516483516,5,18
CN(C)[C@@H]1C(=O)/C(=C(\N)O)C(=O)[C@@]2(O)C(=O)C3=C(O)c4c(O)cccc4[C@@H](O)[C@H]3C[C@@H]12,56,9,47,0.16071428571428573,0.8392857142857143,6,10
CCOC(OCC)C(=O)OCC(=O)C1(O)Cc2c(O)c3c(c(O)c2C(OC2CC(N)C(O)C(C)O2)C1)C(=O)c1c(OC)cccc1C3=O,91,21,70,0.23076923076923078,0.7692307692307693,5,15
NCC1CCC(N)C(OC2C(N)CC(N)C(OC3OC(CO)C(O)C(N)C3O)C2O)O1,70,15,55,0.21428571428571427,0.7857142857142857,9,13
Cc1onc(-c2c(Cl)cccc2Cl)c1C(=O)N[C@@H]1C(=O)N2[C@@H]1SC(C)(C)[C@@H]2C(=O)O,50,9,41,0.18,0.82,2,7
CN[C@@H]1[C@H](O[C@H]2[C@H](O[C@@H]3[C@@H](O)[C@H](O)[C@@H](N=C(N)N)[C@H](O)[C@H]3N=C(N)N)O[C@@H](C)[C@]2(O)CO)O[C@@H](CO)[C@H](O)[C@H]1O,83,23,60,0.27710843373493976,0.7228915662650602,13,15
COc1ccc(-c2cc(=O)c3c(O)cc(O[C@@H]4O[C@H](CO[C@@H]5O[C@@H](C)[C@H](O)[C@@H](O)[C@H]5O)[C@@H](O)[C@H](O)[C@H]4O)cc3o2)cc1O,79,17,62,0.21518987341772153,0.7848101265822784,8,15
CNCC(O)c1ccc(OC(=O)C(C)(C)C)c(OC(=O)C(C)(C)C)c1,54,17,37,0.3148148148148148,0.6851851851851852,2,6
CCC(=O)O[C@H]1[C@H](C)O[C@@H](O[C@@H]2C(C)C(=O)O[C@H](C)[C@H](C)[C@H](OC(=O)CC)[C@@H](C)C(=O)[C@]3(CO3)CC(C)[C@H](O[C@@H]3O[C@H](C)C[C@H](N(C)C)[C@H]3O)[C@H]2C)C[C@@H]1OC,128,26,102,0.203125,0.796875,1,15
OCCN(CCO)c1nc(N2CCCCC2)c2nc(N(CCO)CCO)nc(N3CCCCC3)c2n1,79,16,63,0.20253164556962025,0.7974683544303798,4,12
CC[C@H]1OC(=O)[C@H](C)[C@@H](O[C@H]2C[C@@](C)(OC)[C@@H](O)[C@H](C)O2)[C@H](C)[C@@H](O[C@@H]2O[C@H](C)C[C@H](N(C)C)[C@H]2O)[C@](C)(O)C[C@@H](C)[C@@H]2N[C@@H](COCCOC)O[C@H]([C@H]2C)[C@]1(C)O,139,30,109,0.2158273381294964,0.7841726618705036,5,16
CC(=O)O[C@@]12CO[C@@H]1C[C@H](O)[C@@]1(C)C(=O)[C@H](O)C3=C(C)[C@@H](OC(=O)[C@H](O)[C@@H](NC(=O)OC(C)(C)C)c4ccccc4)C[C@@](O)([C@@H](OC(=O)c4ccccc4)[C@H]21)C3(C)C,116,26,90,0.22413793103448276,0.7758620689655172,5,14
C/C=C/C=C/C1OC(O)(C(CC)C(=O)NC/C=C/C=C(\C)C(OC)C(C)C2OC(/C=C/C=C/C=C(\C)C(=O)c3c(O)n(C)ccc3=O)C(O)C2O)C(O)C(OC2OC(C)C(OC3OC(C)C(OC)C(O)C3OC)C(OC)C2O)C1(C)C,173,46,127,0.2658959537572254,0.7341040462427746,8,21
CC[C@H]1CN2CCc3cc(OC)c(OC)cc3[C@@H]2C[C@@H]1C[C@H]1NCCc2cc(OC)c(OC)cc21.[Cl],79,12,67,0.1518987341772152,0.8481012658227848,1,6
CC1(C)S[C@@H]2[C@H](NC(=O)[C@H](N)C3=CCC=CC3)C(=O)N2[C@H]1C(=O)O,47,9,38,0.19148936170212766,0.8085106382978723,3,6
CCC(C)[C@H]1O[C@]2(CC[C@@H]1C)CC1C[C@@H](C/C=C(\C)[C@@H](O[C@H]3C[C@H](OC)[C@@H](OC4C[C@H](OC)[C@@H](O)[C@H](C)O4)[C@H](C)O3)[C@@H](C)/C=C/C=C3\CO[C@@H]4[C@H](O)C(C)=C[C@@H](C(=O)O1)[C@]34O)O2.CO[C@H]1CC(O[C@H]2[C@H](C)O[C@@H](O[C@@H]3/C(C)=C/C[C@@H]4CC(C[C@]5(CC[C@H](C)[C@@H](C(C)C)O5)O4)OC(=O)[C@@H]4C=C(C)[C@@H](O)[C@H]5OC/C(=C\C=C\[C@@H]3C)[C@]54O)C[C@@H]2OC)O[C@@H](C)[C@@H]1O,281,41,240,0.14590747330960854,0.8540925266903915,6,28
COc1cccc2c1C(=O)c1c(O)c3c(c(O)c1C2=O)C[C@](O)(C(=O)CO)C[C@H]3OC1CC(N)CC(C)O1,71,12,59,0.16901408450704225,0.8309859154929577,5,11
CN(CCN(C)CN/C(O)=C1\C(=O)[C@@H](N(C)C)[C@@H]2C[C@H]3C(=C(O)c4c(O)cccc4[C@@]3(C)O)C(=O)[C@]2(O)C1=O)CN/C(O)=C1\C(=O)[C@@H](N(C)C)[C@@H]2C[C@H]3C(=C(O)c4c(O)cccc4[C@@]3(C)O)C(=O)[C@]2(O)C1=O,139,29,110,0.20863309352517986,0.7913669064748201,12,22
CCNCC(O)c1cccc(O)c1,28,7,21,0.25,0.75,3,3
CCOC(=O)C1=C(C)NC(C)=C(C(=O)OC)C1c1cccc(Cl)c1Cl,45,10,35,0.2222222222222222,0.7777777777777778,1,5
CC1(C)S[C@@H]2[C@H](NC(=O)C(Oc3ccccc3)c3ccccc3)C(=O)N2[C@H]1C(=O)O,55,10,45,0.18181818181818182,0.8181818181818182,2,6
CC(C)c1ccccc1OCC1=NCCN1,35,6,29,0.17142857142857143,0.8285714285714286,1,3
CC(C)(C(=O)O)c1ccc(C(O)CCCN2CCC(C(O)(c3ccccc3)c3ccccc3)CC2)cc1,79,15,64,0.189873417721519,0.810126582278481,3,5
CC(C)(Oc1ccc(Cl)cc1)C(=O)N[C@@H](C(=O)N[C@@H]1C(=O)N2[C@@H]1SC(C)(C)[C@@H]2C(=O)O)c1ccccc1,68,15,53,0.22058823529411764,0.7794117647058824,3,7
CO[C@@]1(NC(=O)CSC(F)(F)F)C(=O)N2C(C(=O)O)=C(CSc3nnnn3CCO)CO[C@@H]21.[Na],52,15,37,0.28846153846153844,0.7115384615384616,3,13
CC[C@H]1OC(=O)[C@H](C)[C@@H](O[C@H]2C[C@@](C)(OC)[C@@H](O)[C@H](C)O2)[C@H](C)[C@@H](O[C@@H]2O[C@H](C)C[C@H](N(C)C)[C@H]2O)[C@](C)(O)C[C@](C)(F)C(=O)[C@H](C)[C@@H](O)[C@]1(C)O,120,25,95,0.20833333333333334,0.7916666666666666,5,14
C[C@@H](O)[C@H]1C(=O)N2C(C(=O)O)=C([C@H]3CCCO3)S[C@H]12,36,6,30,0.16666666666666666,0.8333333333333334,2,6
CC1(C)S[C@@H]2[C@H](NC(=O)[C@@H](N=Cc3ccco3)c3ccc(O)cc3)C(=O)N2[C@H]1C(=O)O,55,11,44,0.2,0.8,3,8
CC(C)CC(OC(=O)c1ccco1)C(=O)N[C@@H]1C(=O)N2[C@@H]1SC(C)(C)[C@@H]2C(=O)O,55,14,41,0.2545454545454545,0.7454545454545455,2,8
CC(=O)O[C@H]1C[C@@]2(C)[C@@H](C[C@@H](O)[C@H]3[C@@]4(C)CC[C@@H](O)[C@@H](C)[C@@H]4CC[C@@]32C)/C1=C(\CCC=C(C)C)C(=O)O,88,16,72,0.18181818181818182,0.8181818181818182,3,6
CNC(C)C1CCC(N)C(OC2C(N)CC(N)C(OC3OCC(C)(O)C(NC)C3O)C2O)O1,78,17,61,0.21794871794871795,0.782051282051282,8,12
CO/N=C(\C(=O)N[C@@H]1C(=O)N(OCC(=O)OCC(=O)OC(C)(C)C)[C@H]1C)c1csc(N)n1,58,19,39,0.3275862068965517,0.6724137931034483,2,12
CC(C)CC1NC(=O)C(CCCN)NC(=O)C(C(C)C)NC(=O)C2CCCN2C(=O)C(Cc2ccccc2)NC(=O)C(CC(C)C)NC(=O)C(CCCN)NC(=O)C(C(C)C)NC(=O)C2CCCN2C(=O)C(Cc2ccccc2)NC1=O,178,26,152,0.14606741573033707,0.8539325842696629,10,12
Cc1c(F)c(N2CCNC(C)C2)cc2c1c(=O)c(C(=O)O)cn2C1CC1,51,6,45,0.11764705882352941,0.8823529411764706,2,6
CN(C)C1C(=O)/C(=C(/O)NCN2CCN(C(=N)N=C(N)N)CC2)C(=O)C2(O)C(=O)C3=C(O)c4c(O)cccc4C(C)(O)C3CC12,87,16,71,0.1839080459770115,0.8160919540229885,9,12
CC1(C)S[C@@H]2[C@H](N3C(=O)[C@@H](c4ccccc4)NC3(C)C)C(=O)N2[C@H]1C(=O)O,53,8,45,0.1509433962264151,0.8490566037735849,2,6
CC(Cc1ccccc1)NO,24,5,19,0.20833333333333334,0.7916666666666666,2,2
CNC(C)C(O)c1ccc(O)cc1,28,7,21,0.25,0.75,3,3
Cc1cc(=O)oc2cc(O)ccc12,22,2,20,0.09090909090909091,0.9090909090909091,1,3
CC(=O)[C@]1(O)Cc2c(O)c3c(c(O)c2[C@@H](O[C@H]2C[C@H](N)[C@H](O)[C@H](C)O2)C1)C(=O)c1ccccc1C3=O,67,10,57,0.14925373134328357,0.8507462686567164,5,10
C[C@H](O)[C@H]1C(=O)N2C(C(=O)O)=C(SCCN=CN)C[C@H]12.O,40,10,30,0.25,0.75,3,6
CNC1C(O)C(OC2C(NC(=O)C(O)CN)CC(N)C(OC3OC(CN)C(O)C(O)C3O)C2O)OCC1(C)O,84,22,62,0.2619047619047619,0.7380952380952381,12,16
CC(C)(Oc1ccccc1)C(=O)N[C@@H]1C(=O)N2[C@@H]1SC(C)(C)[C@@H]2C(=O)O,50,11,39,0.22,0.78,2,6
CO[C@@H]1[C@@H](O[C@@H]2O[C@H](C)[C@@H](O[C@H]3C[C@@](C)(O)[C@@H](OC(=O)CC(C)C)[C@H](C)O3)[C@H](N(C)C)[C@H]2O)[C@@H](CC=O)C[C@@H](C)[C@@H](O)/C=C/C=C/C[C@@H](C)OC(=O)C[C@H]1OC(C)=O,129,28,101,0.21705426356589147,0.7829457364341085,3,16
Cc1oc(=O)oc1COC(=O)[C@@H]1N2C(=O)[C@@H](NC(=O)[C@H](N)c3ccccc3)[C@H]2SC1(C)C,58,12,46,0.20689655172413793,0.7931034482758621,2,9
CNCC[C@@H](O)[C@@H]1C[C@H](SC2=C(C(=O)O)N3C(=O)[C@H]([C@@H](C)O)[C@H]3[C@H]2C)CN1,58,14,44,0.2413793103448276,0.7586206896551724,5,8
COc1cccc2c1C(=O)c1c(O)c3c(c(O)c1C2=O)C[C@@](O)(C(=O)CO)C[C@@H]3O[C@H]1C[C@H](NC(=O)[C@@H](N)CC(C)C)[C@H](O)[C@H](C)O1,91,20,71,0.21978021978021978,0.7802197802197802,7,13
CC[C@H]1OC(=O)[C@H](C)[C@@H](OC2CC(C)(OC)C(O)C(C)O2)C(C)[C@@H](OC2OC(C)CC(N(C)C)C2O)[C@](C)(O)C[C@@H](C)/C(=N\OC)[C@H](C)[C@@H](O)[C@]1(C)O,125,27,98,0.216,0.784,5,15
CCCC1CC(C(=O)NC(C(C)O)C2OC(SC)C(O)C(O)C2O)N(C)C1,62,16,46,0.25806451612903225,0.7419354838709677,5,8
N[C@@H](C(=O)NC1C(=O)N2C(C(=O)O)=C(Cl)CCC12)c1ccccc1.O,44,7,37,0.1590909090909091,0.8409090909090909,3,5
CCCCc1nc(Cl)c(CO)n1Cc1ccc(-c2ccccc2-c2nn[nH]n2)cc1,56,10,46,0.17857142857142858,0.8214285714285714,2,6
CN(C)[C@@H]1C(=O)/C(=C(/N)O)C(=O)[C@@]2(O)C(=O)C3=C(O)c4c(O)ccc(Cl)c4[C@@](C)(O)[C@H]3C[C@@H]12.[Cl-].[H+],59,10,49,0.1694915254237288,0.8305084745762712,6,10
CC1(C)S[C@@H]2[C@H](N=CN3CCCCCC3)C(=O)N2[C@H]1C(=O)O,47,6,41,0.1276595744680851,0.8723404255319149,1,5
CC(CN(C)C)OC(C)(c1ccccc1)c1ccc(Cl)cc1,47,10,37,0.2127659574468085,0.7872340425531915,0,2
CC1OC(OC2CC(O)(C(=O)CO)Cc3c(O)c4c(c(O)c32)C(=O)c2ccccc2C4=O)CC(N)C1O,68,11,57,0.16176470588235295,0.8382352941176471,6,11
C[C@H](O)C1C(=O)N2C(C(=O)O)=C(S[C@@H]3CN[C@H](C(=O)N(C)C)C3)[C@H](C)C12.O.O.O,59,12,47,0.2033898305084746,0.7966101694915254,3,7
C=NC(C(=O)NC1C(=O)N2C1SC(C)(C)C2C(=O)O)c1ccccc1,46,9,37,0.1956521739130435,0.8043478260869565,2,6
C=C1c2cccc(O)c2C(O)=C2C(=O)[C@]3(O)C(=O)/C(=C(/N)O)C(=O)[C@@H](N(C)C)[C@@H]3[C@@H](O)[C@H]12,57,9,48,0.15789473684210525,0.8421052631578947,6,10
CNC(C)C(=O)c1ccc(OC)cc1,29,7,22,0.2413793103448276,0.7586206896551724,1,3
COc1cccc(OC)c1C(=O)N[C@@H]1C(=O)N2[C@@H]1SC(C)(C)[C@@H]2C(=O)O,48,11,37,0.22916666666666666,0.7708333333333334,2,7
CC1(C)S[C@@H]2[C@H](NC(=O)[C@H](NC(=O)N3CCN(S(C)(=O)=O)C3=O)c3ccccc3)C(=O)N2[C@H]1C(=O)O,64,13,51,0.203125,0.796875,3,9
COCC(=O)O[C@]1(CCN(C)CCCc2nc3ccccc3[nH]2)CCc2cc(F)ccc2[C@@H]1C(C)C,77,16,61,0.2077922077922078,0.7922077922077922,1,5
CCC(=O)OC1CC(=O)OC(C)C/C=C/C=C\C(O)C(C)CC(CC=O)C(O[C@@H]2O[C@H](C)[C@@H](O[C@H]3C[C@@](C)(O)[C@H](OC(=O)CC)[C@@H](C)O3)[C@H](N(C)C)[C@H]2O)C1OC,126,27,99,0.21428571428571427,0.7857142857142857,3,16
CCC1NC(=O)C(NC(=O)c2ncccc2O)C(C)OC(=O)C(c2ccccc2)NC(=O)C2CC(=O)CCN2C(=O)C(Cc2ccc(N(C)C)cc2)N(C)C(=O)C2CCCN2C1=O,122,14,108,0.11475409836065574,0.8852459016393442,4,12
CCCCCC1CNC(C(=O)NC(C(C)Cl)C2OC(SC)C(O)C(O)C2O)C1,64,16,48,0.25,0.75,5,7
CO[C@@]12[C@H](COC(N)=O)C3=C(C(=O)C(C)=C(N)C3=O)N1C[C@@H]1N[C@@H]12,45,8,37,0.17777777777777778,0.8222222222222222,3,8
CO[C@@]1(NC(=O)C(C(=O)O)c2ccc(O)cc2)C(=O)N2C(C(=O)O)=C(CSc3nnnn3C)CO[C@@H]21,59,15,44,0.2542372881355932,0.7457627118644068,4,14
NC[C@H]1O[C@H](O[C@H]2[C@H](O)[C@@H](O)[C@H](N)C[C@@H]2N)[C@H](N)[C@@H](O)[C@@H]1O,49,11,38,0.22448979591836735,0.7755102040816326,8,10
CCN[C@@H]1C[C@H](N)[C@@H](O[C@H]2OC(CN)=CC[C@H]2N)[C@H](O)[C@H]1O[C@H]1OC[C@](C)(O)[C@H](NC)[C@H]1O,76,17,59,0.2236842105263158,0.7763157894736842,8,12
COC(=O)C1=C(C)NC(C)=C(C(=O)OCCN(C)Cc2ccccc2)C1c1cccc([N+](=O)[O-])c1,66,15,51,0.22727272727272727,0.7727272727272727,1,8
COC(=O)C1=C(C)NC(C)=C(C(=O)OC)C1c1ccccc1[N+](=O)[O-],44,10,34,0.22727272727272727,0.7727272727272727,1,7
CCOC(=O)C1=C(C)NC(C)=C(C(=O)OC)C1c1cccc([N+](=O)[O-])c1,47,11,36,0.23404255319148937,0.7659574468085106,1,7
CN(C)[C@@H]1C(=O)/C(=C(\N)O)C(=O)[C@@]2(O)C(=O)C3=C(O)c4c(O)ccc([N+](=O)[O-])c4C[C@H]3C[C@@H]12,57,9,48,0.15789473684210525,0.8421052631578947,5,11
CO[C@@H]1[C@@H](OC(N)=O)[C@@H](O)[C@H](Oc2ccc3c(=O)c(NC(=O)c4ccc(O)c(CC=C(C)C)c4)c(O)oc3c2C)OC1(C)C,83,20,63,0.24096385542168675,0.7590361445783133,5,11
COC1CC(O[C@H]2[C@H](C)[C@@H](OC3OC(C)CC(N(C)C)C3O)[C@@H](C)C[C@]3(CO3)C(=O)[C@H](C)[C@@H](O)[C@@H](C)[C@@H](C)OC(=O)[C@@H]2C)OC(C)C1O,112,20,92,0.17857142857142858,0.8214285714285714,3,13
CC1(C)S[C@@H]2[C@H]([NH+]3C(=O)C(c4ccc(O)cc4)NC3(C)C)C(=O)N2[C@H]1C(=O)O,55,9,46,0.16363636363636364,0.8363636363636363,4,7
CO/N=C(\C(=O)NC1C(=O)N(OCC(=O)O)[C@H]1C)c1csc(N)n1,40,12,28,0.3,0.7,3,10
CC(=O)O[C@H]1C(=O)[C@@]2(C)C([C@H](OC(=O)c3ccccc3)[C@]3(O)C[C@H](OC(=O)[C@H](O)[C@@H](NC(=O)c4ccccc4)c4ccccc4)C(C)=C1C3(C)C)[C@]1(OC(C)=O)CO[C@@H]1C[C@@H]2O,119,24,95,0.20168067226890757,0.7983193277310925,4,14
CN(C)[C@@H]1C(=O)/C(=C(/O)NCN2CCCC(C(=O)O)C2)C(=O)[C@@]2(O)C(=O)C3=C(O)c4c(O)cccc4[C@@](C)(O)[C@H]3C[C@@H]12,81,14,67,0.1728395061728395,0.8271604938271605,7,13
CC(=O)OCOC(=O)C1N2C(=O)C(NC(=O)Cc3ccccc3)C2SC1(C)C,52,12,40,0.23076923076923078,0.7692307692307693,1,7
CC1(C)SC2C(NC(=O)Cc3ccccc3)C(=O)N2C1C(=O)O.[Na],43,8,35,0.18604651162790697,0.813953488372093,2,5
CN(C)[C@@H]1C(=O)/C(=C(/O)NCNC(C(=O)NC2C(=O)N3C2SC(C)(C)C3C(=O)O)c2ccccc2)C(=O)[C@@]2(O)C(=O)C3=C(O)c4c(O)cccc4[C@@](C)(O)[C@H]3C[C@@H]12,106,21,85,0.19811320754716982,0.8018867924528302,9,16
CC(Oc1ccccc1)C(=O)NC1C(=O)N2C1SC(C)(C)C2C(=O)O,47,10,37,0.2127659574468085,0.7872340425531915,2,6
CN(C)C1C(=O)/C(=C(/O)NCN2CCN(CCO)CC2)C(=O)C2(O)C(=O)C3=C(O)c4c(O)cccc4C(C)(O)C3CC12,84,15,69,0.17857142857142858,0.8214285714285714,7,13
COc1cccc2c1C(=O)c1c(O)c3c(c(O)c1C2=O)C[C@@](O)(C(=O)CO)C[C@@H]3O[C@H]1C[C@H](N)[C@H](O[C@H]2CCCCO2)[C@H](C)O1,87,14,73,0.16091954022988506,0.8390804597701149,5,13
CC1(C)SC2C(N(C(=N)c3ccncc3)[C@H](C(=O)NC(=O)CN)c3ccccc3)C(=O)N2C1C(=O)O,65,14,51,0.2153846153846154,0.7846153846153846,4,9
CC1(C)S[C@@H]2[C@H](NC(=O)[C@H](NC(=O)c3ccc(-c4ccc(S(=O)(=O)N(CCO)CCO)cc4)[nH]c3=O)c3ccc(O)cc3)C(=O)N2[C@H]1C(=O)[O-].[Na+],88,20,68,0.22727272727272727,0.7727272727272727,6,12
CC1(C)S[C@@H]2[C@H](NC(=O)[C@H](NC(=O)Nc3cnc(Nc4ccc(S(N)(=O)=O)cc4)[nH]c3=O)c3ccc(O)cc3)C(=O)N2[C@H]1C(=O)O,78,17,61,0.21794871794871795,0.782051282051282,8,12
CC(C)(C)C(=O)OCOC(=O)[C@@H]1N2C(=O)[C@@H](NC(=O)[C@H](N)c3ccccc3)[C@H]2SC1(C)C,63,16,47,0.25396825396825395,0.746031746031746,2,8
CNCC(O)c1cccc(OC(=O)C(C)(C)C)c1,39,11,28,0.28205128205128205,0.717948717948718,2,4
Cc1cnn(-c2c(Cl)cccc2Cl)c1C(=O)N[C@@H]1C(=O)N2[C@@H]1SC(C)(C)[C@@H]2C(=O)O,51,9,42,0.17647058823529413,0.8235294117647058,2,7
CC1NC(=O)C(NC(=O)c2ncccc2O)C(C)OC(=O)C(c2ccccc2)NC(=O)C2CC(=O)CCN2C(=O)C(Cc2ccc(N(C)C)cc2)N(C)C(=O)C2CCCN2C1=O,119,13,106,0.1092436974789916,0.8907563025210085,4,12
CCCNCC(O)COc1ccccc1C(=O)CCc1ccccc1,53,13,40,0.24528301886792453,0.7547169811320755,2,4
CCC(Oc1ccccc1)C(=O)NC1C(=O)N2C1SC(C)(C)C2C(=O)O,50,11,39,0.22,0.78,2,6
NCC1OC(OC2C(N)CC(NC(CO)CO)C(OC3OC(CO)C(O)C(N)C3O)C2O)C(N)C(O)C1O,83,22,61,0.26506024096385544,0.7349397590361446,13,17
CC1(C)S[C@@H]2[C@H](NC(=O)c3nc4ccccc4nc3C(=O)O)C(=O)N2[C@H]1C(=O)O,48,9,39,0.1875,0.8125,3,9
CO[C@H]1/C=C/O[C@@]2(C)Oc3c(C)c(O)c4c(c3C2=O)C2=NC3(CCN(CC(C)C)CC3)NC2=C(NC(=O)/C(C)=C\C=C\[C@H](C)[C@H](O)[C@@H](C)[C@@H](O)[C@@H](C)[C@H](OC(C)=O)[C@@H]1C)C4=O,128,19,109,0.1484375,0.8515625,5,14
CCN(CC)C(C)=NN=Cc1c2c(O)c3c(O)c(C)c4c(c3c1O)C(=O)C(C)(OC=CC(OC)C(C)C(OC(C)=O)C(C)C(O)C(C)C(O)C(C)C=CC=C(C)C(=O)N2)O4,123,25,98,0.2032520325203252,0.7967479674796748,6,14
CCN(CC)c1nc2c(s1)c1c(O)c3c(O)c(C)c4c(c32)C(=O)[C@@](C)(O/C=C/[C@H](OC)[C@@H](C)[C@@H](OC(C)=O)[C@H](C)[C@H](O)[C@H](C)[C@@H](O)[C@@H](C)/C=C/C=C(/C)C(=O)N1)O4,116,21,95,0.1810344827586207,0.8189655172413793,5,14
CCN(CC)C(=O)COc1cc2c(O)c3c(O)c(C)c4c(c13)C(=O)[C@@](C)(O/C=C/[C@H](OC)[C@@H](C)[C@@H](OC(C)=O)[C@H](C)[C@H](O)[C@H](C)[C@@H](O)[C@@H](C)/C=C/C=C(/C)C(=O)N2)O4,119,24,95,0.20168067226890757,0.7983193277310925,5,13
CO[C@H]1/C=C/O[C@@]2(C)Oc3c(C)c(O)c4c(O)c(cc(O)c4c3C2=O)NC(=O)/C(C)=C\C=C\[C@H](C)[C@H](O)[C@@H](C)[C@@H](O)[C@@H](C)[C@H](OC(C)=O)[C@@H]1C,100,17,83,0.17,0.83,6,12
CO[C@H]1/C=C/O[C@@]2(C)Oc3c(C)c(O)c4c(c3C2=O)C(=O)/C(=C/NN2CCN(C3CCCC3)CC2)C(=C4O)NC(=O)/C(C)=C\C=C\[C@H](C)[C@H](O)[C@@H](C)[C@@H](O)[C@@H](C)[C@H](OC(C)=O)[C@@H]1C,132,19,113,0.14393939393939395,0.8560606060606061,6,15
CO[C@H]1/C=C/O[C@@]2(C)Oc3c(C)c(O)c4c(O)c(c5c(nc6cc(C)ccn65)c4c3C2=O)NC(=O)/C(C)=C\C=C\[C@H](C)[C@H](O)[C@@H](C)[C@@H](O)[C@@H](C)[C@H](OC(C)=O)[C@@H]1C,113,17,96,0.1504424778761062,0.8495575221238938,5,13
C[C@@H](O)[C@H]1C(=O)N2C(C(=O)[O-])=C(COC(N)=O)S[C@H]12.[Na+],31,8,23,0.25806451612903225,0.7419354838709677,2,7
CC[C@@]1(O)C[C@H](O[C@H]2C[C@H](N(C)C)[C@H](O[C@H]3C[C@@H]4O[C@H]5CC(=O)[C@H](C)O[C@H]5O[C@@H]4[C@H](C)O3)[C@H](C)O2)c2c(O)c3c(c(O)c2[C@H]1O[C@H]1C[C@H](N(C)C)[C@H](O)[C@H](C)O1)C(=O)c1cccc(O)c1C3=O,139,23,116,0.16546762589928057,0.8345323741007195,5,19
CC1(C)S[C@@H]2[C@H](NC(=O)[C@H](NC(=O)Cc3ccc(C4=NCCCN4)cc3)c3ccccc3)C(=O)N2[C@H]1C(=O)O,74,13,61,0.17567567567567569,0.8243243243243243,4,8
CC[C@H]1OC(=O)[C@H](C)[C@@H](O[C@H]2C[C@@](C)(OC)[C@@H](O)[C@H](C)O2)[C@H](C)[C@@H](O[C@@H]2O[C@H](C)C[C@H](N(C)C)[C@H]2O)[C@](C)(O)C[C@@H](C)/C(=N/OCOCCOC)[C@H](C)[C@@H](O)[C@]1(C)O,136,32,104,0.23529411764705882,0.7647058823529411,5,17
COC1CCCC2C1=C(C(=O)[O-])N1C(=O)C(C(C)O)C21,40,6,34,0.15,0.85,1,5
COCOC(=O)C1N2C(=O)C(N3C(=O)C(c4ccc(O)cc4)NC3(C)C)C2SC1(C)C,61,12,49,0.19672131147540983,0.8032786885245902,2,8
COCOC(=O)[C@@H]1N2C(=O)[C@@H](N3C(=O)C(c4ccccc4)NC3(C)C)[C@H]2SC1(C)C,60,11,49,0.18333333333333332,0.8166666666666667,1,7
CC(=O)OC1/C=C/C(C)=C/CC(O)/C=C/C(C)=C/C(NC(=O)C(C)=O)C2(C)C(=O)OC(C1)C(C)C2=O,72,12,60,0.16666666666666666,0.8333333333333334,2,8
CN[C@@H]1[C@@H](O)[C@@H](O[C@@H]2[C@@H](O)[C@H](O[C@H]3OC(CN)=CC[C@H]3N)[C@@H](N)C[C@H]2N)OC[C@]1(C)O,70,15,55,0.21428571428571427,0.7857142857142857,8,12
COC1C(O)CC(=O)OC(C)C/C=C/C=C/C(OC2CCC(N(C)C)C(C)O2)C(C)CC(CC=O)C1OC1OC(C)C(OC2CC(C)(O)C(O)C(C)O2)C(N(C)C)C1O,136,26,110,0.19117647058823528,0.8088235294117647,4,16
CC1(C)S[C@@H]2[C@H](NC(=O)C(c3ccccc3)S(=O)(=O)O)C(=O)N2[C@H]1C(=O)O,47,10,37,0.2127659574468085,0.7872340425531915,3,8
C[C@@H](O)[C@H]1C(=O)N2C(C(=O)O)=C(SC3CCS(=O)C3)S[C@H]12,38,7,31,0.18421052631578946,0.8157894736842105,2,7
CC1(C)S[C@@H]2[C@H](NC(=O)[C@H](N)c3ccccc3)C(=O)N2[C@H]1C(=O)O.CC1(C)[C@H](C(=O)O)N2C(=O)C[C@H]2S1(=O)=O,72,13,59,0.18055555555555555,0.8194444444444444,4,11
CC1(C)S[C@@H]2[C@H](NC(=O)[C@H](NS(=O)(=O)[O-])c3ccccc3)C(=O)N2[C@H]1C(=O)[O-].[Na+].[Na+],47,9,38,0.19148936170212766,0.8085106382978723,2,8
C=CC[C@@H]1/C=C(\C)C[C@H](C)C[C@H](OC)[C@H]2O[C@@](O)(C(=O)C(=O)N3CCCC[C@H]3C(=O)O[C@H](/C(C)=C/[C@@H]3CC[C@@H](O)[C@H](OC)C3)[C@H](C)[C@@H](O)CC1=O)[C@H](C)C[C@@H]2OC,129,18,111,0.13953488372093023,0.8604651162790697,3,12
CC1(C)S[C@@H]2[C@H](NC(=O)[C@H](N)c3ccccc3)C(=O)N2[C@H]1C(=O)OC1OC(=O)c2ccccc21,61,10,51,0.16393442622950818,0.8360655737704918,2,8
C[C@]1(Cn2ccnn2)[C@H](C(=O)O)N2C(=O)C[C@H]2S1(=O)=O,34,5,29,0.14705882352941177,0.8529411764705882,1,8
CCCCCCCCCC(=O)N[C@H]1[C@H](Oc2c3cc4cc2Oc2ccc(cc2Cl)[C@@H](O[C@@H]2O[C@H](CO)[C@@H](O)[C@H](O)[C@H]2NC(C)=O)[C@@H]2NC(=O)[C@H](NC(=O)[C@@H]4NC(=O)[C@H]4NC(=O)[C@@H](Cc5ccc(c(Cl)c5)O3)NC(=O)[C@H](N)c3ccc(O)c(c3)Oc3cc(O)cc4c3)c3ccc(O)c(c3)-c3c(O[C@H]4O[C@H](CO)[C@@H](O)[C@H](O)[C@@H]4O)cc(O)cc3[C@H](C(=O)O)NC2=O)O[C@H](CO)[C@@H](O)[C@@H]1O,242,40,202,0.1652892561983471,0.8347107438016529,24,34
CO[C@@]1(NC(=O)C(C(=O)O)c2ccsc2)C(=O)N2[C@@H](C(=O)O)C(C)(C)S[C@@H]21,47,12,35,0.2553191489361702,0.7446808510638298,3,9
Cn1c(=O)c2c(ncn2CCNCC(O)c2ccc(O)c(O)c2)n(C)c1=O,50,11,39,0.22,0.78,4,10
CC1(C)SC2C(NC(=O)CSc3ccccc3)C(=O)N2C1C(=O)O,44,9,35,0.20454545454545456,0.7954545454545454,2,6
CC1(C)[C@H](NC(=O)/C(=N\OCC(=O)O)c2csc(N)n2)C(=O)N1OS(=O)(=O)O,44,14,30,0.3181818181818182,0.6818181818181818,4,13
CC(C)C(=O)OCc1cccc(OC(=O)[C@@H]2N3C(=O)[C@@H](NC(=O)Cc4ccccc4)[C@H]3SC2(C)C)c1,69,15,54,0.21739130434782608,0.782608695652174,1,7
NC[C@H]1O[C@H](O[C@H]2[C@H](O)[C@@H](O[C@H]3O[C@H](CO)[C@@H](O)[C@H](N)[C@H]3O)[C@H](N)C[C@@H]2N)[C@H](N)C[C@@H]1O,71,16,55,0.22535211267605634,0.7746478873239436,10,14
Cc1ccc(C(=O)c2cc(O)c(O)c([N+](=O)[O-])c2)cc1,32,6,26,0.1875,0.8125,2,5
CO[C@H]1C[C@H](O[C@H]2[C@H](C)[C@@H](O[C@@H]3O[C@H](C)C[C@H](N(C)C)[C@H]3OC(C)=O)[C@@H](C)C[C@@]3(CO3)C(=O)[C@H](C)[C@@H](OC(C)=O)[C@@H](C)[C@@H](C)OC(=O)[C@@H]2C)O[C@@H](C)[C@@H]1OC(C)=O,127,26,101,0.2047244094488189,0.7952755905511811,0,16
CCCC[C@@H]1CC(=O)[C@]2(O)O[C@@H]3[C@@H](NC)[C@@H](O)[C@@H](NC)[C@H](O)[C@H]3O[C@@H]2O1,58,11,47,0.1896551724137931,0.8103448275862069,5,9
Cc1ccc(C(C)C)c(OCC2=NCCN2)c1,38,7,31,0.18421052631578946,0.8157894736842105,1,3
CC[C@]1(O)C[C@H]2CN(CCc3c([nH]c4ccccc34)[C@@](C(=O)OC)(c3cc4c(cc3OC)N(C)[C@H]3[C@@](O)(C(N)=O)[C@H](O)[C@]5(CC)C=CCN6CC[C@]43[C@@H]65)C2)C1,118,16,102,0.13559322033898305,0.864406779661017,5,10
CC1=C/C(O)CC(=O)Cc2nc(co2)C(=O)N2CCC=C2C(=O)OC(C(C)C)C(C)/C=C\C(=O)NC/C=C\1,75,6,69,0.08,0.92,2,8
[C-]#[N+]C(=C\c1ccc(O)cc1)/C(=C/c1ccc(O)cc1)[N+]#[C-],35,5,30,0.14285714285714285,0.8571428571428571,2,2
COc1cccc2c1C(=O)c1c(O)c3c(c(O)c1C2=O)C[C@@](O)(/C(C)=N/NC(=O)c1ccccc1)C[C@@H]3O[C@H]1C[C@H](N)[C@H](O)[C@H](C)O1.[Cl-].[H+],87,15,72,0.1724137931034483,0.8275862068965517,6,12
FC(F)(Cl)C(F)(F)Cl,7,1,6,0.14285714285714285,0.8571428571428571,0,0
C[C@H]1CCCC[C@@]1(c1cccs1)N1CCCCC1,45,3,42,0.06666666666666667,0.9333333333333333,0,2
CC(Cc1ccccc1)NCCn1cnc2c1c(=O)n(C)c(=O)n2C.[Cl-].[H+],50,9,41,0.18,0.82,1,7
CC(=O)NCCCN1CCN(c2cc(Cl)ccc2Cl)CC1,43,7,36,0.16279069767441862,0.8372093023255814,1,3
CC(=O)OC1CC[C@@]2(C)C([C@@H]1Br)[C@H](Br)C[C@H]1[C@@H]3CC[C@H]([C@H](C)CCCC(C)C)[C@@]3(C)CC[C@@H]12,84,13,71,0.15476190476190477,0.8452380952380952,0,2
CCC(Br)(CC)C(=O)NC(=O)NC(C)=O,29,10,19,0.3448275862068966,0.6551724137931034,2,3
CC(=O)OCC(=O)OCC/C(SC(=O)c1ccco1)=C(/C)N(C=O)Cc1cnc(C)nc1N,58,18,40,0.3103448275862069,0.6896551724137931,1,11
CC(=O)NC(CCC(N)=O)C(=O)O,24,9,15,0.375,0.625,3,4
CC(=O)NCC1(c2ccccc2)CCN(CCCC(=O)c2ccc(F)cc2)CC1,60,10,50,0.16666666666666666,0.8333333333333334,1,3
CC(=O)Nc1ccc(OC(=O)c2ccccc2O)cc1,34,7,27,0.20588235294117646,0.7941176470588235,2,4
CC(=O)Nc1nnc(S(N)(=O)=O)s1,19,5,14,0.2631578947368421,0.7368421052631579,2,6
CC(=O)OCC/C(SC(C)=O)=C(/C)N(C=O)Cc1cnc(C)nc1N,47,15,32,0.3191489361702128,0.6808510638297872,1,8
CC(=O)SCC(Cc1ccccc1)C(=O)NCC(=O)OCc1ccccc1,51,13,38,0.2549019607843137,0.7450980392156863,1,5
CCC[C@@](C)(O)[C@H]1CC23C=CC1(OC)[C@H]1Oc4c(OC(C)=O)ccc5c4C12CCN(C)C3C5,73,12,61,0.1643835616438356,0.8356164383561644,1,6
CCC(OC(C)=O)C(CC(C)N(C)C)(c1ccccc1)c1ccccc1,58,14,44,0.2413793103448276,0.7586206896551724,0,3
CC(=O)OCC1=CO[C@@H](OC(=O)CC(C)C)[C@H]2C1=C[C@H](OC(=O)CC(C)(C)OC(C)=O)[C@]21CO1,68,19,49,0.27941176470588236,0.7205882352941176,0,10
C=CC1O[C@@H]2CC3C4CCC5=CC(=O)C=CC5(C)C4(F)C(O)CC3(C)[C@]2(C(=O)CO)O1,64,7,57,0.109375,0.890625,2,6
Nc1nc(=O)c2ncn(COCCO)c2[nH]1,28,6,22,0.21428571428571427,0.7857142857142857,3,7
O=C(COc1ccc(Cl)cc1)OCCNC12CC3CC(CC(C3)C1)C2,54,8,46,0.14814814814814814,0.8518518518518519,1,4
O=C(NCCN1CCN(c2ncccn2)CC1)C12CC3CC(CC(C3)C1)C2,62,6,56,0.0967741935483871,0.9032258064516129,1,5
CC(N)C(=O)OC(C)(C)Cc1ccc(Cl)cc1,35,9,26,0.2571428571428571,0.7428571428571429,1,3
CCC(=O)OCC(=O)[C@@]1(OC(=O)CC)[C@H](C)C[C@H]2[C@H]3[C@H]([C@@H](O)C[C@@]21C)[C@@]1(C)C=CC(=O)C=C1C[C@H]3Cl,76,14,62,0.18421052631578946,0.8157894736842105,1,7
CCCN(CCC)C1Cc2cccc3cc(O)cc(c23)C1,48,8,40,0.16666666666666666,0.8333333333333334,1,2
CC12CC(=O)[C@H]3C(CC[C@H]4C[C@H](O)CCC43C)[C@@H]1CCC2C(=O)CO,60,6,54,0.1,0.9,2,4
CC(=O)[C@H]1CC[C@H]2[C@@H]3CC[C@H]4C[C@H](O)CC[C@]4(C)[C@H]3C(=O)C[C@]12C,59,5,54,0.0847457627118644,0.9152542372881356,1,3
CC(=O)C12OC(C)(C)OC1CC1C3CCC4=CC(=O)CCC4(C)C3CCC12C,66,6,60,0.09090909090909091,0.9090909090909091,0,4
COC1(F)C(F)(F)C1(F)Cl,13,2,11,0.15384615384615385,0.8461538461538461,0,1
C=CCN1CCC23c4c5ccc(O)c4OC2C2(OC)C=CC3(CC2[C@](C)(O)CCC)C1C5,72,11,61,0.1527777777777778,0.8472222222222222,2,5
C=CCN1C(=O)OC(C)C1=O,20,3,17,0.15,0.85,0,3
CNC[C@@H]1CN(c2ccc(OCc3cccc(Cl)c3)cc2)C(=O)O1,45,7,38,0.15555555555555556,0.8444444444444444,1,4
CCCN(CCCCN1C(=O)CC2(CCCC2)CC1=O)C1COc2cccc(OC)c2C1.[Cl-].[H+],73,11,62,0.1506849315068493,0.8493150684931506,0,5
O=C1CCC2(CCC(=O)c3ccccc32)C(=O)N1,33,0,33,0.0,1.0,1,3
CC(=O)NCCn1c(C)cc(C=O)c1C,31,8,23,0.25806451612903225,0.7419354838709677,1,3
CC(CC#N)N(C)CC(=O)N(C)c1ccc(Cl)cc1C(=O)c1ccccc1F,50,11,39,0.22,0.78,0,4
CCC(=O)O[C@]1(c2ccccc2)CCN(C)C[C@@H]1CC,46,8,38,0.17391304347826086,0.8260869565217391,0,3
CC[C@@H](O)C(C[C@@H](C)N(C)C)(c1ccccc1)c1ccccc1,53,12,41,0.22641509433962265,0.7735849056603774,1,2
C=CCN1CCCC1CNC(=O)c1cc(S(=O)(=O)NC)c(N)cc1OC,53,12,41,0.22641509433962265,0.7735849056603774,3,6
O=C(O)CN1C(=O)c2cccc3cccc(c23)C1=O,30,3,27,0.1,0.9,1,4
CCC1(CC)O[C@@H]2C[C@H]3C4CCC5=CC(=O)C=CC5(C)[C@@]4(F)[C@@H](O)CC3(C)[C@]2(C(=O)CO)O1,72,10,62,0.1388888888888889,0.8611111111111112,2,6
CC12C[C@H](O)[C@@]3(F)C(CCC4=CC(=O)C=CC43C)[C@@H]1C[C@H]1O[C@@](C)(c3ccccc3)O[C@]12C(=O)CO,74,8,66,0.10810810810810811,0.8918918918918919,2,6
CC(=O)OCC(=O)[C@@]12OC3(CCCC3)O[C@@H]1C[C@H]1[C@@H]3CCC4=CC(=O)C=C[C@]4(C)[C@@]3(F)[C@@H](O)C[C@@]12C,76,8,68,0.10526315789473684,0.8947368421052632,1,7
CCC(=O)O[C@]1(C(=O)COC)[C@@H](C)C[C@H]2[C@@H]3CCC4=CC(=O)C=C[C@]4(C)[C@@]3(F)[C@@H](O)C[C@@]21C,71,12,59,0.16901408450704225,0.8309859154929577,1,6
Cc1cccc(C)c1NC(=O)c1ccc(N)cc1,35,6,29,0.17142857142857143,0.8285714285714286,2,2
CC(C)n1cc2c3c(cccc31)C1C[C@@H](C(=O)NC3CCCCC3)CN(C)C1C2,68,7,61,0.10294117647058823,0.8970588235294118,1,3
CC(Cc1ccccc1)NC(C#N)c1ccccc1,38,6,32,0.15789473684210525,0.8421052631578947,1,2
O=C(O)CCCCCC[NH2+]C1c2ccccc2CCc2ccccc21.[Cl-],55,9,46,0.16363636363636364,0.8363636363636363,2,2
CCN1CCCC1CNC(=O)c1cc(S(=O)(=O)CC)c(N)cc1OC,53,12,41,0.22641509433962265,0.7735849056603774,2,6
C[N+](C)([O-])CCC=C1c2ccccc2CCc2ccccc21,47,5,42,0.10638297872340426,0.8936170212765957,0,1
CC(C)CCOC(CN1CCCC1)c1ccccc1,47,9,38,0.19148936170212766,0.8085106382978723,0,2
CCNC(=O)N1CCN(CCCC(c2ccc(F)cc2)c2ccc(F)cc2)CC1,60,10,50,0.16666666666666666,0.8333333333333334,1,2
Nc1cccc(-n2ccccc2=O)c1,25,2,23,0.08,0.92,1,3
CN(C)c1cnccn1,18,3,15,0.16666666666666666,0.8333333333333334,0,3
CCC(C)(C)O,17,5,12,0.29411764705882354,0.7058823529411765,1,1
CCOC(=O)C1(c2ccccc2)CCN(CCc2ccc(N)cc2)CC1,56,9,47,0.16071428571428573,0.8392857142857143,1,4
COc1ccc(C(=O)N2CCCC2=O)cc1,30,4,26,0.13333333333333333,0.8666666666666667,0,3
COc1cc2oc(=O)c(C)c(C)c2cc1OCCCN1CCN(c2ccccc2OC)CC1,68,12,56,0.17647058823529413,0.8235294117647058,0,7
CCCNC(=O)c1ccc2c(c1)N([C@H](C)CN1CCCC1)c1ccccc1S2,60,9,51,0.15,0.85,1,4
C=CCC1(C(C)C)C(=O)NC(=O)NC1=O,29,5,24,0.1724137931034483,0.8275862068965517,2,3
O=C1CCc2ccc(OCCCCN3CCN(c4cccc(Cl)c4Cl)CC3)cc2N1,60,7,53,0.11666666666666667,0.8833333333333333,1,4
O=C1C(O)=C(O)OC1C(O)CO,20,6,14,0.3,0.7,4,6
CC(=O)Oc1ccccc1C(=O)O,21,5,16,0.23809523809523808,0.7619047619047619,1,4
CCN(CC)c1ccc(NC(=O)c2ccccc2N)c(C)c1,46,10,36,0.21739130434782608,0.782608695652174,2,3
CN1C2CCC1CC(OC(=O)C(C)(CO)c1ccccc1)C2,49,8,41,0.16326530612244897,0.8367346938775511,1,4
C[N+]1([O-])C2CCC1CC(OC(=O)C(CO)c1ccccc1)C2,47,7,40,0.14893617021276595,0.851063829787234,1,4
CN(C(=O)CNC(=O)[C@@H](N)CCCCN)c1ccc(Cl)cc1C(=O)c1ccccc1,58,15,43,0.25862068965517243,0.7413793103448276,3,5
O=c1[nH]c2cc(Cl)ccc2n1C1CCN(CC2COc3ccccc3O2)CC1,54,3,51,0.05555555555555555,0.9444444444444444,1,5
Nc1ccc(S(=O)(=O)N2CC3CCC(CC3)C2)cc1,41,3,38,0.07317073170731707,0.926829268292683,1,3
O=C(CCCN1CCN2CCCC2C1)c1ccc(F)cc1,46,5,41,0.10869565217391304,0.8913043478260869,0,3
OC(c1ccccc1)(c1ccccc1)C1CCNCC1,43,4,39,0.09302325581395349,0.9069767441860465,2,2
O=C1NCCN1C1CCN(CCC2COc3ccccc3O2)CC1,52,4,48,0.07692307692307693,0.9230769230769231,1,4
c1ccc2c(c1)CCN1CCNCC21,32,0,32,0.0,1.0,1,2
c1ccc2c(c1)cc1n2CCCNC1,30,0,30,0.0,1.0,1,2
CN(CCc1cc2cccc3c2n1-c1ccccc1CC3)Cc1ccccc1,58,6,52,0.10344827586206896,0.896551724137931,0,2
O=c1[nH]c2ccccc2c(=O)n1CCN1C[C@H]2C[C@H](c3ccc(F)cc3)[C@H]2C1,54,4,50,0.07407407407407407,0.9259259259259259,1,4
CCN(CCO)CCn1c(Cc2ccccc2)nc2c1c(=O)n(C)c(=O)n2C,57,12,45,0.21052631578947367,0.7894736842105263,1,8
CCC1(CC)C(=O)NC(=O)NC1=O,25,4,21,0.16,0.84,2,3
Cc1nc2n(n1)C(N1CCN(C)CC1)=Nc1ccccc1C2,45,3,42,0.06666666666666667,0.9333333333333333,0,6
O=C(CCCl)NCc1ccccc1,25,5,20,0.2,0.8,1,1
C[C@H]1C[C@H]2[C@@H]3CCC4=CC(=O)C=C[C@]4(C)[C@@]3(Cl)[C@@H](O)C[C@]2(C)[C@@]1(O)C(=O)CO,60,8,52,0.13333333333333333,0.8666666666666667,3,5
COC[C@H]1CN(c2ccc(OCC[C@@H](O)C(F)(F)F)cc2)C(=O)O1,43,10,33,0.23255813953488372,0.7674418604651163,1,5
CCC1(C)CC(=O)NC(=O)C1,24,3,21,0.125,0.875,1,2
C/C(=C(\CCOP(=O)(O)O)SC(=O)c1ccccc1)N(C=O)Cc1cnc(C)nc1N,55,16,39,0.2909090909090909,0.7090909090909091,3,10
CC(=O)Nc1ccc(OC(=O)c2ccccc2OC(C)=O)cc1,39,9,30,0.23076923076923078,0.7692307692307693,1,5
O=C1CNC(c2ccccc2)=c2c3c(sc2=N1)CCCC3,40,1,39,0.025,0.975,1,3
C/C(=C(\CCOC(=O)c1ccccc1)SC(=O)c1ccccc1)N(C=O)Cc1cnc(C)nc1N,63,15,48,0.23809523809523808,0.7619047619047619,1,8
C[N+](C)([O-])CC/C=C1/c2ccccc2C=Cc2c(Cl)cccc21,45,5,40,0.1111111111111111,0.8888888888888888,0,1
[Cl].c1ccc(Cn2cc(CCc3ccncc3)c3ccccc32)cc1,47,5,42,0.10638297872340426,0.8936170212765957,0,2
OCc1ccccc1,16,2,14,0.125,0.875,1,1
CN1CCc2cc(Cl)c(O)cc2[C@@H](c2cc(Br)cc3c2OCC3)C1,46,3,43,0.06521739130434782,0.9347826086956522,1,3
CCOC(=O)C[C@@H](O)C[C@@H](O)/C=C/C1=C(c2ccc(F)cc2)c2ccccc2OC12CCCC2,68,12,56,0.17647058823529413,0.8235294117647058,2,5
C[C@H]1C[C@H]2[C@@H]3CCC4=CC(=O)C=C[C@]4(C)[C@@]3(F)[C@@H](O)C[C@]2(C)[C@@]1(OC(=O)c1ccccc1)C(=O)CO,73,10,63,0.136986301369863,0.863013698630137,2,6
CCCCC(=O)O[C@]1(C(=O)CO)[C@@H](C)C[C@H]2[C@@H]3CCC4=CC(=O)C=C[C@]4(C)[C@@]3(F)[C@@H](O)C[C@@]21C,74,13,61,0.17567567567567569,0.8243243243243243,2,6
O=C1CC2(CCCC2)CC(=O)N1CCNCC1COc2ccccc2O1,55,5,50,0.09090909090909091,0.9090909090909091,1,5
O=C(O)CCCCC1SCC2NC(=O)NC21,33,6,27,0.18181818181818182,0.8181818181818182,3,4
O=C1C[C@H]2SC(C3(O)CN4C(=O)C[C@H]4S3)CN12,32,2,30,0.0625,0.9375,1,5
O=C(CCCN1CCN2Cc3[nH]c4ccccc4c3CC2C1)c1ccc(F)cc1,59,5,54,0.0847457627118644,0.9152542372881356,1,3
C/C(=C(/CCOC(=O)c1ccccc1)SS/C(CCOC(=O)c1ccccc1)=C(\C)N(C=O)Cc1cnc(C)nc1N)N(C=O)Cc1cnc(C)nc1N,99,27,72,0.2727272727272727,0.7272727272727273,2,14
CC(=O)NCCC[C@H](NC(C)=O)C(=O)O,30,11,19,0.36666666666666664,0.6333333333333333,3,4
CCN1CCN(c2cc(-c3ccc(F)cc3)c3c(n2)CCCCCC3)CC1,60,4,56,0.06666666666666667,0.9333333333333333,0,3
CC[C@]12CCN(CC3(O)CC3)[C@H](Cc3ccc(O)cc31)C2(C)C,55,8,47,0.14545454545454545,0.8545454545454545,2,3
CC1(C)OC(=O)Nc2ccc(Br)cc21,25,2,23,0.08,0.92,1,2
CC(C)C(Br)C(=O)NC(N)=O,21,7,14,0.3333333333333333,0.6666666666666666,2,2
BrC(Br)Br,4,0,4,0.0,1.0,0,0
Cc1cc(Br)cc(C(N)=O)c1O,20,4,16,0.2,0.8,2,2
O=C1CC(c2cccc(Br)c2)C(=O)N1,23,1,22,0.043478260869565216,0.9565217391304348,1,2
Cc1nnc2n1-c1sc(Br)cc1C(c1ccccc1Cl)=NC2,35,2,33,0.05714285714285714,0.9428571428571428,0,5
Nc1nc(=O)c2ncn(CC[C@@H](O)CO)c2[nH]1,31,7,24,0.22580645161290322,0.7741935483870968,4,7
CC(=O)Nc1ccc(OC(C)(C)C)cc1,32,8,24,0.25,0.75,1,2
CC(C)(C)[C@]1(O)CCN2C[C@H]3c4ccccc4CCc4cccc(c43)[C@@H]2C1.[Cl-].[H+],62,5,57,0.08064516129032258,0.9193548387096774,1,2
CCCC(=O)c1ccc2c(c1)N(CCCN1CCN(C)CC1)c1ccccc1S2,63,9,54,0.14285714285714285,0.8571428571428571,0,5
CCCCC(CC)CNC(=O)CC(C)O,39,13,26,0.3333333333333333,0.6666666666666666,2,2
Oc1ccc2c(c1)[C@@]13CCCC[C@@]1(O)[C@@H](C2)N(CC1CCC1)CC3,57,4,53,0.07017543859649122,0.9298245614035088,2,3
C=CCN1C[C@H](C(=O)N(CCCN(C)C)C(=O)NCC)C[C@@H]2c3cccc4[nH]cc(c34)C[C@H]21,73,14,59,0.1917808219178082,0.8082191780821918,2,4
CC(NCCn1cnc2c1c(=O)n(C)c(=O)n2C)C(O)c1ccccc1,51,10,41,0.19607843137254902,0.803921568627451,2,8
CN(C)C(=O)OC1N=C(c2ccccc2)c2cc(Cl)ccc2N(C)C1=O,46,7,39,0.15217391304347827,0.8478260869565217,0,4
CC12CCC(CC1=O)C2(C)C,28,3,25,0.10714285714285714,0.8928571428571429,0,1
CCCCC/C(=N/OCCN)c1ccc(C)c(N)c1,44,12,32,0.2727272727272727,0.7272727272727273,2,4
CCCCSc1ccc(C(SCCN(C)C)c2ccccc2)cc1,54,13,41,0.24074074074074073,0.7592592592592593,0,3
CCCCC1(CCOC(N)=O)C(=O)NC(=O)NC1=O,36,9,27,0.25,0.75,3,5
CN1C(=O)CN(C(N)=O)C(c2ccccc2)c2cc(Cl)ccc21,41,4,37,0.0975609756097561,0.9024390243902439,1,2
C#CC(OC(N)=O)c1ccccc1,22,4,18,0.18181818181818182,0.8181818181818182,1,2
O=C(O)C1CCN1C12CC3CC(CC(C3)C1)C2,41,3,38,0.07317073170731707,0.926829268292683,1,3
NC(=O)CN1Cc2ccccc2OC1=O,26,3,23,0.11538461538461539,0.8846153846153846,1,3
CC(C)NC(=O)OC1CCN(CCCC(=O)c2ccc(F)cc2)CC1,53,11,42,0.20754716981132076,0.7924528301886793,1,4
CCC(=O)c1ccc2c(c1)N(CCCN1CCN(CCO)CC1)c1ccccc1S2,64,10,54,0.15625,0.84375,1,6
NS(=O)(=O)c1ccc(C(=O)O)cc1,20,4,16,0.2,0.8,2,4
C[C@H](N)C(=O)c1ccccc1,22,4,18,0.18181818181818182,0.8181818181818182,1,2
O=C1CN(C(=O)CN2CC(c3ccc(Cl)cc3)CC2=O)CCN1,43,4,39,0.09302325581395349,0.9069767441860465,1,3
OC1OC(COCCOC(O)C(Cl)(Cl)Cl)C(OC2OC(COCCOCCOC(O)C(Cl)(Cl)Cl)CC(OC(O)C(Cl)(Cl)Cl)C2O)C(OCCOCCOC(O)C(Cl)(Cl)Cl)C1O,108,38,70,0.35185185185185186,0.6481481481481481,7,19
COCc1c(C(C)C)nc(C(C)C)c(/C=C/[C@@H](O)C[C@@H](O)CC(=O)O)c1-c1ccc(F)cc1,68,19,49,0.27941176470588236,0.7205882352941176,3,6
Cc1cc(C)c(=O)[nH]n1,17,2,15,0.11764705882352941,0.8823529411764706,1,2
CC(=O)c1ccc(C(O)C(CO)NC(=O)C(Cl)Cl)cc1,35,10,25,0.2857142857142857,0.7142857142857143,3,4
CCOC(=O)OCC/C(SC(=O)OCC)=C(\C)N(C=O)Cc1cnc(C)nc1N,55,19,36,0.34545454545454546,0.6545454545454545,1,10
OC[C@@H](O)[C@H]1OC2O[C@H](C(Cl)(Cl)Cl)O[C@@H]2[C@H]1O,29,6,23,0.20689655172413793,0.7931034482758621,3,6
CC(CC(C)(C)O)OC(O)C(Cl)(Cl)Cl,28,10,18,0.35714285714285715,0.6428571428571429,2,3
CN1C(=O)CCS(=O)(=O)C1c1ccc(Cl)cc1,30,2,28,0.06666666666666667,0.9333333333333333,0,3
ClC(Cl)Cl,4,0,4,0.0,1.0,0,0
O=C(O)c1cc(=O)c2ccccc2o1,21,2,19,0.09523809523809523,0.9047619047619048,1,4
CC(C)C(=O)OCC(=O)[C@@]12O[C@H](C3CCCCC3)O[C@@H]1C[C@H]1[C@@H]3CCC4=CC(=O)C=C[C@]4(C)[C@H]3[C@@H](O)C[C@@]12C,88,11,77,0.125,0.875,1,7
Clc1ccccc1C1=NCc2nnc(C3CCCCC3)n2-c2sc(Br)cc21,49,2,47,0.04081632653061224,0.9591836734693877,0,5
CC(=O)OCC(=O)[C@@]12OC(C)(C)O[C@@H]1C[C@H]1C3CC(C#N)=C4C=C(OCCCl)CCC4(C)[C@@]3(F)C(O)CC12C,80,13,67,0.1625,0.8375,1,8
CC(C)N[C@H]1C2CCC(CC2)[C@]1(O)c1ccc(Cl)c(Cl)c1,46,6,40,0.13043478260869565,0.8695652173913043,2,2
NNCC1CCCCC1,25,3,22,0.12,0.88,2,2
CC(C)C(O)C1CCCCC1,31,5,26,0.16129032258064516,0.8387096774193549,1,1
COCC1CN(c2ccc(OCc3cccc(C#N)c3)cc2)C(=O)O1,45,7,38,0.15555555555555556,0.8444444444444444,0,5
COc1cc(/C=C/C(=O)N2CCCCCCC2)cc(OC)c1OC,52,9,43,0.17307692307692307,0.8269230769230769,0,4
N#CCCN1C(=O)C(O)N=C(c2ccccc2F)c2cc(Cl)ccc21,40,4,36,0.1,0.9,1,4
CN(C(=O)CNC1CC1)c1ccc(Cl)cc1C(=O)c1ccccc1Cl,45,8,37,0.17777777777777778,0.8222222222222222,1,3
CC1(C)O[C@@H]2C[C@H]3C4C[C@H](F)C5=CC(=O)C=C[C@]5(C)[C@@]4(F)[C@@H](O)C[C@]3(C)[C@]2(C(=O)COC(=O)C2CC2)O1,76,10,66,0.13157894736842105,0.868421052631579,1,7
CN1CCC2=C(CC1)c1cc(C#N)ccc1Sc1ccccc12,44,1,43,0.022727272727272728,0.9772727272727273,0,3
COc1cc(N)c(Cl)cc1C(=O)NC1CCN(Cc2ccccc2)CC1,52,8,44,0.15384615384615385,0.8461538461538461,2,4
Clc1cccc(Cl)c1NC1=NCCO1,23,2,21,0.08695652173913043,0.9130434782608695,1,3
C[C@H]1C[C@H]2[C@@H]3CCC4=CC(=O)C=C[C@]4(C)[C@@]3(F)C(=O)C[C@]2(C)[C@@]1(O)C(=O)CCl,57,6,51,0.10526315789473684,0.8947368421052632,1,4
CCCC(=O)O[C@]1(C(=O)CCl)[C@@H](C)C[C@H]2[C@@H]3CCC4=CC(=O)C=C[C@]4(C)[C@@]3(F)C(=O)C[C@@]21C,68,10,58,0.14705882352941177,0.8529411764705882,0,5
NC(=O)C1(N2CCCCC2)CCN(CCCN2c3ccccc3CCc3ccc(Cl)cc32)CC1,75,7,68,0.09333333333333334,0.9066666666666666,1,4
C[C@@H]1CC2C3C[C@H](F)C4=CC(=O)C=CC4(C)[C@@]3(Cl)C(O)CC2(C)C1C(=O)CO,59,7,52,0.11864406779661017,0.8813559322033898,2,4
CC(=O)OCC(=O)[C@H]1[C@H](C)C[C@H]2[C@@H]3C[C@H](F)C4=CC(=O)C=C[C@]4(C)C3(Cl)[C@@H](O)C[C@@]21C,64,9,55,0.140625,0.859375,1,5
C[C@@H]1CC2C3C[C@H](F)C4=CC(=O)C=CC4(C)[C@@]3(Cl)C(O)CC2(C)C1C(=O)COC(=O)C(C)(C)C,73,12,61,0.1643835616438356,0.8356164383561644,1,5
CN(C)CCCn1c(=O)n(-c2ccccc2)c2cc(Cl)ccc21,45,7,38,0.15555555555555556,0.8444444444444444,0,4
CCN(CC)CCOC1(c2ccc(Cl)cc2)CCCCC1,50,9,41,0.18,0.82,0,2
O=C(CCCN1CCC(O)(c2ccc(Cl)c(C(F)(F)F)c2)CC1)c1ccc(F)cc1,54,8,46,0.14814814814814814,0.8518518518518519,1,3
OCCN1CCN(CC/C=C2/c3ccccc3Sc3ccc(Cl)cc32)CC1,55,6,49,0.10909090909090909,0.8909090909090909,1,4
O=c1[nH]c2ccccc2c(=O)n1CCCN1CCN(c2cccc(Cl)c2)CC1,54,5,49,0.09259259259259259,0.9074074074074074,1,5
C[C@]12C=CC(=O)C=C1C(Cl)=C[C@@H]1[C@@H]2[C@@H](O)C[C@@]2(C)[C@H]1CC[C@]2(O)C(=O)CO,55,7,48,0.12727272727272726,0.8727272727272727,3,5
O=C(OCC(Cl)(Cl)Cl)OCC(Cl)(Cl)Cl,17,6,11,0.35294117647058826,0.6470588235294118,0,3
C#CCN(C)CCCOc1ccc(Cl)cc1Cl,32,7,25,0.21875,0.78125,0,2
O=C(CCCN1CCC(C(=O)c2ccc(Cl)cc2)CC1)c1ccc(F)cc1,52,7,45,0.1346153846153846,0.8653846153846154,0,3
CN1CCN(C2Cc3ccccc3Sc3ccc(Cl)cc32)CC1,47,2,45,0.0425531914893617,0.9574468085106383,0,3
CCc1cc2c(s1)N(C)C(=O)CN=C2c1ccccc1Cl,38,4,34,0.10526315789473684,0.8947368421052632,0,3
CCC(=O)O[C@]1(C(=O)SCCl)[C@H](C)C[C@H]2C3C[C@H](F)C4=CC(=O)C=C[C@]4(C)[C@@]3(F)[C@@H](O)C[C@@]21C,68,11,57,0.16176470588235295,0.8382352941176471,1,6
CNC(=O)CCN1CCN(CCC=C2c3ccccc3Sc3ccc(Cl)cc32)CC1,61,8,53,0.13114754098360656,0.8688524590163934,1,4
CCC12CCN(CC3CCC3)C(Cc3ccc(O)cc31)C2(C)C,57,7,50,0.12280701754385964,0.8771929824561403,1,2
CC[C@H]1CC(=O)[C@@H]2Oc3c(OC)ccc4c3[C@@]23CCN(CC2CC2)C(C4)[C@H]13,61,6,55,0.09836065573770492,0.9016393442622951,0,4
CC1CC2C3CC(F)(F)C4=CC(=O)C=C[C@]4(C)C3(F)C(O)CC2(C)C1(O)C(=O)CO,60,8,52,0.13333333333333333,0.8666666666666667,3,5
CC12CCC(=O)C=C1CCC1C2CCC2(C)C1CCC2(O)C(=O)CO,58,6,52,0.10344827586206896,0.896551724137931,2,4
CC(=O)OCC(=O)[C@@]1(O)CC[C@H]2[C@@H]3CCC4=CC(=O)CC[C@]4(C)[C@H]3C(=O)C[C@@]21C,62,8,54,0.12903225806451613,0.8709677419354839,1,6
CC1=C[C@@H]2[C@H]([C@@H](O)C[C@@]3(C)[C@H]2C[C@@H](C)[C@]3(O)C(=O)COC(=O)c2cccc(S(=O)(=O)O)c2)[C@@]2(C)Cc3cnn(-c4ccccc4)c3C=C12,94,14,80,0.14893617021276595,0.851063829787234,3,10
CC(=O)OCC(=O)[C@@]1(O)[C@H](C)C[C@H]2[C@@H]3C=C(C)C4=Cc5c(cnn5-c5ccccc5)C[C@]4(C)[C@H]3[C@@H](O)C[C@@]21C,82,12,70,0.14634146341463414,0.8536585365853658,2,7
CN1C(=O)CCC1c1cccnc1,26,2,24,0.07692307692307693,0.9230769230769231,0,2
CN(C)CC(=O)C=C1c2ccccc2CCc2ccccc21,45,5,40,0.1111111111111111,0.8888888888888888,0,2
CC1CC(OC(=O)C2CCC(=O)N2)CC(C)(C)C1,42,6,36,0.14285714285714285,0.8571428571428571,1,3
C/C=C/C(=O)N(CC)C(CC)C(=O)N(C)C,37,12,25,0.32432432432432434,0.6756756756756757,0,2
O=C(Nc1ccccc1)OCC1(COC(=O)Nc2ccccc2)CCCC1,53,10,43,0.18867924528301888,0.8113207547169812,2,4
CN(C)C1CCc2[nH]c3ccccc3c2C1,36,3,33,0.08333333333333333,0.9166666666666666,1,1
CCC1(C2=CCCCC2)C(=O)NC(=O)NC1=O,34,3,31,0.08823529411764706,0.9117647058823529,2,3
CN(C)CCC=C1c2ccccc2C=Cc2ccccc21,44,5,39,0.11363636363636363,0.8863636363636364,0,1
CC(=O)[C@H]1CC[C@H]2[C@@H]3C[C@@H](O)C45CC4CC[C@]5(C)[C@H]3CC[C@]12C,59,5,54,0.0847457627118644,0.9152542372881356,1,2
C/C(=C1/CCOC(=O)S1)N(C=O)Cc1cnc(C)nc1N,38,7,31,0.18421052631578946,0.8157894736842105,1,7
NC(=O)C1c2ccccc2CCc2ccccc21,35,2,33,0.05714285714285714,0.9428571428571428,1,1
COC12C=CC3(CC1C(C)(C)O)[C@@H]1Cc4ccc(O)c5c4[C@]3(CCN1CC1CC1)[C@@H]2O5,70,9,61,0.12857142857142856,0.8714285714285714,2,5
CN(C)CCOC(=O)CCC1CCCCC1,41,9,32,0.21951219512195122,0.7804878048780488,0,3
OC(c1ccccc1)(c1ccccc1)C1CC1c1ccncc1,45,5,40,0.1111111111111111,0.8888888888888888,1,2
O=C1NC(=O)C2(c3ccc(Cl)cc3)CC12,25,1,24,0.04,0.96,1,2
CN(C)CC(=O)N1c2ccccc2Sc2ccccc21,38,5,33,0.13157894736842105,0.868421052631579,0,3
OC(C1=NCCN1)(c1ccc(Cl)cc1)c1ccccn1,36,4,32,0.1111111111111111,0.8888888888888888,2,4
CCCCCCCCCCOc1c(OC)cc(C(N)=O)cc1OC,55,17,38,0.3090909090909091,0.6909090909090909,1,4
Cc1ccc(Cc2ccccc2)c(N2CCNCC2)c1,44,4,40,0.09090909090909091,0.9090909090909091,1,2
O=C1CN(O)C(c2ccccc2)=c2cc(Cl)ccc2=N1,33,2,31,0.06060606060606061,0.9393939393939394,1,3
CCCCn1c(=O)c2c(ncn2CC(C)=O)n(CCCC)c1=O,48,11,37,0.22916666666666666,0.7708333333333334,0,7
CC(=O)C1(O)CCC2C3CCC4=CC(=O)C=CC4(C)C3C(O)CC21C,56,6,50,0.10714285714285714,0.8928571428571429,2,4
Nc1ncc2ncn(COCCO)c2n1,27,6,21,0.2222222222222222,0.7777777777777778,2,7
CC(=O)[C@@]1(O)[C@H](O)C[C@H]2[C@@H]3CCC4=CC(=O)C=C[C@]4(C)[C@@]3(F)[C@@H](O)C[C@@]21C,57,7,50,0.12280701754385964,0.8771929824561403,3,5
CC1(C)O[C@@H]2C[C@H]3C4CCC5=CC(=O)C=CC5(C)[C@H]4C(O)CC3(C)[C@]2(C(=O)CO)O1,66,8,58,0.12121212121212122,0.8787878787878788,2,6
C[C@@H]1C[C@H]2[C@@H]3CCC4=CC(=O)C=C[C@]4(C)[C@@]3(F)[C@@H](O)C[C@]2(C)[C@H]1C(=O)CO,59,7,52,0.11864406779661017,0.8813559322033898,2,4
Cc1cccc(Cc2cnc[nH]2)c1C,29,4,25,0.13793103448275862,0.8620689655172413,1,1
CC(=O)OCC(=O)[C@@]1(OC(=O)c2ccco2)[C@H](C)C[C@H]2[C@@H]3CCC4=CC(=O)C=C[C@]4(C)[C@@]3(F)[C@@H](O)C[C@@]21C,75,12,63,0.16,0.84,1,8
c1ccc([C@@H]2CN3CCSC3=N2)cc1,28,1,27,0.03571428571428571,0.9642857142857143,0,3
c1ccc(C2CN=C3NCCN32)cc1,29,1,28,0.034482758620689655,0.9655172413793104,1,3
c1ccc(C2(c3ccccc3)OC[C@H]([C@@H]3CCCCN3)O2)cc1,49,3,46,0.061224489795918366,0.9387755102040817,1,3
CC12C=CC(=O)C=C1CCC1C3CC[C@](O)(C(=O)CO)C3(C)CC(Cl)[C@@]12Cl,56,6,50,0.10714285714285714,0.8928571428571429,2,4
CC(=O)OCC(=O)[C@@]1(O)CCC2C3CCC4=CC(=O)C=CC4(C)[C@@]3(Cl)C(Cl)CC21C,61,8,53,0.13114754098360656,0.8688524590163934,1,5
CCN(CC)CCNC(=O)c1cc(Cl)cc(Cl)c1OC,40,11,29,0.275,0.725,1,3
CC(=O)O[C@H]1C[C@@H]2C(COC(=O)CC(C)C)=CO[C@@H](OC(=O)CC(C)C)[C@@H]2[C@@]12CO2,64,16,48,0.25,0.75,0,8
CCCCOCC(CN1C(=O)N(CC(COCCCC)OC(N)=O)C(=O)C(CC)(c2ccccc2)C1=O)OC(N)=O,84,25,59,0.2976190476190476,0.7023809523809523,2,9
Fc1ccc(C(CCCN2CCN(CCNc3ccccc3)CC2)c2ccc(F)cc2)cc1,69,10,59,0.14492753623188406,0.855072463768116,1,3
C[C@@H]1CC2C3C[C@H](F)C4=CC(=O)C=CC4(C)[C@@]3(F)C(O)CC2(C)C1C(=O)CO,59,7,52,0.11864406779661017,0.8813559322033898,2,4
C[C@@H]1C[C@H]2[C@@H]3C[C@H](F)C4=CC(=O)C=C[C@]4(C)[C@@]3(F)[C@@H](O)C[C@]2(C)[C@H]1C(=O)COC(=O)C(C)(C)C,73,12,61,0.1643835616438356,0.8356164383561644,1,5
CN1CCC(C)(CN2c3ccccc3Sc3ccccc32)C1,47,4,43,0.0851063829787234,0.9148936170212766,0,3
CC1(C)OC(=O)NC1=O,16,2,14,0.125,0.875,1,3
CN(C)CCn1cnc2c1c(=O)n(C)c(=O)n2C,36,7,29,0.19444444444444445,0.8055555555555556,0,7
CC(Cc1ccccc1)N(C)C,29,6,23,0.20689655172413793,0.7931034482758621,0,1
O=C1CN2C(=O)CCC2N1,19,0,19,0.0,1.0,1,2
CCCCCCCCCC1(C)OCC(COC(N)=O)O1,49,14,35,0.2857142857142857,0.7142857142857143,1,4
CC(=O)NNC(=O)CC(O)(c1ccccc1)c1ccccc1,41,9,32,0.21951219512195122,0.7804878048780488,3,3
CO[C@]12CC[C@@]3(C[C@@H]1C(C)(C)O)[C@H]1Cc4ccc(O)c5c4[C@@]3(CCN1CC1CC1)[C@H]2O5,72,9,63,0.125,0.875,2,5
CCc1c(OC)nc2nc(C(=O)c3ccccc3)cn2c1C,41,7,34,0.17073170731707318,0.8292682926829268,0,5
CC12NC(Cc3ccccc31)c1ccccc12,35,1,34,0.02857142857142857,0.9714285714285714,1,1
CCCC(=O)O[C@]1(C(C)=O)CCC[C@H]2[C@@H]3CCC4=CC(=O)C=C[C@]4(C)[C@H]3[C@@H](O)C[C@@]21C,70,10,60,0.14285714285714285,0.8571428571428571,1,5
COc1cc2c(cc1OC)C(=O)C(CC1CCN(Cc3ccccc3)CC1)C2.[Cl-].[H+],60,8,52,0.13333333333333333,0.8666666666666667,0,4
O=C(NCCc1ccc(O)c(O)c1)C12CC3CC(CC(C3)C1)C2,51,7,44,0.13725490196078433,0.8627450980392157,3,3
CCN1CC(CCN2CCOCC2)C(c2ccccc2)(c2ccccc2)C1=O,61,7,54,0.11475409836065574,0.8852459016393442,0,3
COc1ccc2c(c1OC)[C@]13CCN(C)[C@H](C2)[C@]1(O)CC[C@@H](O)C3,54,7,47,0.12962962962962962,0.8703703703703703,2,5
CNCCC(Oc1cccc2ccccc12)c1cccs1,42,7,35,0.16666666666666666,0.8333333333333334,1,3
O=C(c1ccc(F)cc1)C1CCN(CCCN2c3ccccc3Sc3ccc(C(F)(F)F)cc32)CC1,66,7,59,0.10606060606060606,0.8939393939393939,0,4
O=C(CN1CCCC1=O)NNC(=O)CN1CCCC1=O,39,7,32,0.1794871794871795,0.8205128205128205,2,4
CCC(=O)N(c1ccc(Cl)c(Cl)c1)[C@@H]1CCC[C@H]1N(C)C,44,8,36,0.18181818181818182,0.8181818181818182,0,2
CC1=NN(c2ccccc2)C(=O)C1,24,2,22,0.08333333333333333,0.9166666666666666,0,2
Cc1nccn1C(C)c1ccccc1,29,4,25,0.13793103448275862,0.8620689655172413,0,2
CCN(CC)C/C=C1/c2ccccc2Nc2cc(Cl)ccc21,45,6,39,0.13333333333333333,0.8666666666666667,1,2
CCS(=O)(=O)CCN1C(=O)CN=C(c2ccccc2F)c2cc(Cl)ccc21,47,6,41,0.1276595744680851,0.8723404255319149,0,4
Fc1ccc(-c2ccc(CN3CCN(c4cccc5ccoc45)CC3)[nH]2)cc1,54,4,50,0.07407407407407407,0.9259259259259259,1,3
c1cc2c(c(N3CCNCC3)c1)OCCO2,34,1,33,0.029411764705882353,0.9705882352941176,1,4
CCC(CC)(CNC(=O)CCCO)c1cccc(OC)c1,48,14,34,0.2916666666666667,0.7083333333333334,2,3
COc1ccccc1N1CCN(CC(O)COc2cc(OC)c(OC)c(OC)c2)CC1,65,15,50,0.23076923076923078,0.7692307692307693,1,8
CCOC(=O)N(Cc1ccccc1)C1CC1,34,7,27,0.20588235294117646,0.7941176470588235,0,2
OC1CCN(c2ccc(-c3ccc(Cl)cc3Cl)nn2)CC1,38,3,35,0.07894736842105263,0.9210526315789473,1,4
CCN(CC)C(=O)[C@H]1[C@H](C(=O)N(CC)CC)[C@H]2C=C[C@@H]1C2,50,12,38,0.24,0.76,0,2
CC(=O)C1CCC2C3CC(C)C4=CC(=O)C=CC4(C)C3C(O)CC12C,58,6,52,0.10344827586206896,0.896551724137931,1,3
CC1OC2(CCCCC2Oc2cccc(Cl)c2)NC1=O,40,3,37,0.075,0.925,1,3
CCCCCCCNC(=O)Oc1ccc2c(c1)[C@]1(C)CCN(C)[C@@H]1N2C,61,13,48,0.21311475409836064,0.7868852459016393,1,4
CN1CCC2=C(CC1)c1ccccc1N(C)c1ccccc12,47,2,45,0.0425531914893617,0.9574468085106383,0,2
CCN1CCCC1CNC(=O)c1cc(C(C)=O)ccc1OC,47,10,37,0.2127659574468085,0.7872340425531915,1,4
CCN(CC)CCn1cnc2c1c(=O)n(C)c(=O)n2C,42,9,33,0.21428571428571427,0.7857142857142857,0,7
CCNC1=Nc2ccc(Cl)cc2C(c2ccccc2)S1,37,4,33,0.10810810810810811,0.8918918918918919,1,3
CCOC1c2ccccc2C(=O)N(C)c2ccccc21,39,4,35,0.10256410256410256,0.8974358974358975,0,2
CCCCNCC1COc2cccc(OCC)c2O1.[Cl-].[H+],43,9,34,0.20930232558139536,0.7906976744186046,1,4
CCCl,7,1,6,0.14285714285714285,0.8571428571428571,0,0
C=C,5,0,5,0.0,1.0,0,0
CCC1(CC)C(=O)NC=C(C)C1=O,28,5,23,0.17857142857142858,0.8214285714285714,1,2
CCNC1(c2ccccc2)CCCCC1,37,4,33,0.10810810810810811,0.8918918918918919,1,1
CCNC1=Nc2ccc(Cl)cc2C(C)(c2ccccc2)O1.[Cl-].[H+],40,5,35,0.125,0.875,1,3
CCC(C(N)=O)N1CCCC1=O,26,5,21,0.19230769230769232,0.8076923076923077,1,2
CCN(CC)S(=O)(=O)N[C@H]1C[C@@H]2c3cccc4[nH]cc(c34)C[C@H]2N(C)C1,57,8,49,0.14035087719298245,0.8596491228070176,2,3
O=C(O)/C=C/C(=O)O.OCCOCCOCCN1CCN(C(c2ccccc2)c2ccc(Cl)cc2)CC1,73,16,57,0.2191780821917808,0.7808219178082192,3,9
CCc1nn(CCCN2CCN(c3cccc(Cl)c3)CC2)c(=O)n1CC,56,9,47,0.16071428571428573,0.8392857142857143,0,6
CCCC(C)(O)C1CC23C=CC1(OC)C1Oc4c(O)ccc5c4C12CCN(C)C3C5,68,10,58,0.14705882352941177,0.8529411764705882,2,5
CCC1(c2ccccc2)OCC(C2CCCCN2)O1,44,4,40,0.09090909090909091,0.9090909090909091,1,3
CC(=O)OCC(CCn1cnc2cnc(N)nc21)COC(C)=O,43,12,31,0.27906976744186046,0.7209302325581395,1,9
CN(C)CCCn1c(=O)c2ccccc2c2ccccc21,43,6,37,0.13953488372093023,0.8604651162790697,0,3
CCc1c(OC)nc2nc(-c3noc(C)n3)cn2c1C,37,7,30,0.1891891891891892,0.8108108108108109,0,7
O=C1CC[C@H](C(=O)N2CCCCC2)N1,31,2,29,0.06451612903225806,0.9354838709677419,1,2
CCCCOCC(CN1C(=O)NC(=O)C(CC)(c2ccccc2)C1=O)OC(N)=O,57,14,43,0.24561403508771928,0.7543859649122807,2,6
NC(=O)OCC(COC(N)=O)c1ccccc1,31,9,22,0.2903225806451613,0.7096774193548387,2,4
COc1ccc(OCC2CN(C)CCC2c2ccccc2)cc1,50,7,43,0.14,0.86,0,3
O=C(CCCN1CCN(C(=O)OC2CCCCC2)CC1)c1ccc(F)cc1,58,8,50,0.13793103448275862,0.8620689655172413,0,4
CCC(C(=O)OCCN1CCOC(c2ccccc2)C1C)c1ccccc1,58,10,48,0.1724137931034483,0.8275862068965517,0,4
CCNC1C2CCC(C2)C1c1ccccc1,39,4,35,0.10256410256410256,0.8974358974358975,1,1
CCCCN/C(=C1/C=C(Cl)C=CC1=O)c1ccccc1Cl,39,6,33,0.15384615384615385,0.8461538461538461,1,2
c1ccc(CC2NCCc3c2[nH]c2ccccc32)cc1,41,2,39,0.04878048780487805,0.9512195121951219,2,1
CCC1C(=O)NC(=O)C1(C)c1ccccc1,32,4,28,0.125,0.875,1,2
Clc1ccc(OCC2=NCCN2)cc1Cl,26,3,23,0.11538461538461539,0.8846153846153846,1,3
CC1NC(=O)COC1c1ccccc1,28,2,26,0.07142857142857142,0.9285714285714286,1,2
CN1CC(=O)N=C1NC(=O)Nc1cccc(Cl)c1,30,5,25,0.16666666666666666,0.8333333333333334,2,3
CCNC1=NC(=O)C(c2ccccc2)O1,28,4,24,0.14285714285714285,0.8571428571428571,1,3
CC(C)(O)CC(C)(O)c1ccc(Cl)cc1,32,8,24,0.25,0.75,2,2
Cn1nc(-c2cccnc2)nc1-c1ccccc1CO,36,5,31,0.1388888888888889,0.8611111111111112,1,5
O=C(COc1ccc(Cl)cc1)N1CCN(Cc2ccc3c(c2)OCO3)CC1,51,6,45,0.11764705882352941,0.8823529411764706,0,5
CC(C)(C)NCC(O)c1ccccc1F,33,8,25,0.24242424242424243,0.7575757575757576,2,2
CS(=O)(=O)c1ccc([C@@H](O)[C@@H](CF)NC(=O)C(Cl)Cl)cc1,35,9,26,0.2571428571428571,0.7428571428571429,2,4
CCN(CC)CCC(=O)N1c2ccccc2Sc2ccc(C(F)(F)F)cc21,50,9,41,0.18,0.82,0,3
CC(=O)OCC(=O)C12N=C(C)OC1CC1C3CCC4=CC(=O)C=CC4(C)[C@@]3(F)C(O)CC12C,67,9,58,0.13432835820895522,0.8656716417910447,1,7
CCOC(=O)N(CCN(C)C)c1cccc(C(F)(F)F)c1,40,11,29,0.275,0.725,0,3
COc1ccc(S(N)(=O)=O)cc1C(=O)NCC1CCCN1Cc1ccc(F)cc1,55,10,45,0.18181818181818182,0.8181818181818182,2,5
CC1(C)O[C@@H]2CC3C4C[C@H](F)C5=CC(=O)C=CC5(C)[C@@]4(Cl)C(Cl)CC3(C)[C@]2(C(=O)CO)O1,65,7,58,0.1076923076923077,0.8923076923076924,1,5
C[C@]12CCC(=O)C=C1CC[C@H]1[C@@H]3CC[C@](O)(C(=O)CO)[C@@]3(C)C[C@H](O)[C@@]12F,59,7,52,0.11864406779661017,0.8813559322033898,3,5
CC(=O)OCC(=O)[C@@]1(O)CC[C@H]2[C@@H]3CCC4=CC(=O)CC[C@]4(C)[C@@]3(F)[C@@H](O)C[C@@]21C,64,9,55,0.140625,0.859375,2,6
Cc1cc2c(s1)=Nc1ccc(F)cc1NC=2N1CCN(C)CC1,45,3,42,0.06666666666666667,0.9333333333333333,1,5
COC(OC)C(=O)[C@@]12OC(C)(C)O[C@@H]1CC1C3C[C@H](F)C4=CC(=O)C=CC4(C)[C@@]3(F)C(O)CC12C,73,11,62,0.1506849315068493,0.8493150684931506,1,7
CC(=O)OCC(=O)[C@@]12OC(C)(C)O[C@@H]1C[C@H]1[C@@H]3C[C@H](F)C4=CC(=O)C=C[C@]4(C)[C@@]3(F)[C@@H](O)C[C@@]12C,71,10,61,0.14084507042253522,0.8591549295774648,1,7
CCCCOC(=O)C(=O)C1C(C)CC2C3CC(F)C4=CC(=O)C=CC4(C)C3C(O)CC21C,70,11,59,0.15714285714285714,0.8428571428571429,1,5
CCCCCC(=O)OCC(=O)C1C(C)CC2C3CC(F)C4=CC(=O)C=CC4(C)C3C(O)CC21C,76,13,63,0.17105263157894737,0.8289473684210527,1,5
CCS(=O)(=O)c1ccc(F)cc1,21,3,18,0.14285714285714285,0.8571428571428571,0,2
CC(=O)O[C@]1(C(C)=O)CC[C@H]2[C@@H]3C[C@H](C)C4=CC(=O)C=C[C@]4(C)[C@@]3(F)[C@@H](O)C[C@@]21C,64,9,55,0.140625,0.859375,1,5
C[C@H]1c2ccccc2[C@@H](CCCN(C)C)c2cc(C(F)(F)F)ccc21,51,8,43,0.1568627450980392,0.8431372549019608,0,1
CNCCC(Oc1ccc(C(F)(F)F)cc1)c1ccccc1,41,8,33,0.1951219512195122,0.8048780487804879,1,2
CCCCCCC(=O)OCCN1CCN(CCCN2c3ccccc3Sc3ccc(C(F)(F)F)cc32)CC1,79,15,64,0.189873417721519,0.810126582278481,0,6
OCCOC1CCN(CCCN2c3ccccc3Sc3ccc(C(F)(F)F)cc32)CC1,61,9,52,0.14754098360655737,0.8524590163934426,1,5
NC(=O)NCCN1CCN(c2cccc(C(F)(F)F)c2)CC1,42,7,35,0.16666666666666666,0.8333333333333334,2,3
O=C1NCN(c2ccccc2)C12CCN(CCCC(c1ccc(F)cc1)c1ccc(F)cc1)CC2,70,7,63,0.1,0.9,1,3
O=C1CN2CCOC2(c2ccccc2F)c2cc(Cl)ccc2N1CCO,47,4,43,0.0851063829787234,0.9148936170212766,1,4
CN1C(=O)C(O)N=C(c2ccccc2F)c2cc(Cl)ccc21,36,3,33,0.08333333333333333,0.9166666666666666,1,3
CC1CC2C3CC(F)C4=CC(=O)C=CC4(C)C3(F)C(O)CC2(C)C1(O)C(=O)SCF,60,8,52,0.13333333333333333,0.8666666666666667,2,5
CCC(=O)O[C@]1(C(=O)SCF)[C@H](C)C[C@H]2[C@@H]3C[C@H](F)C4=CC(=O)C=C[C@]4(C)[C@@]3(F)[C@@H](O)C[C@@]21C,68,11,57,0.16176470588235295,0.8382352941176471,1,6
OCCN1CCN(CCCN2c3cc(C(F)(F)F)ccc3Sc3sccc32)CC1,56,8,48,0.14285714285714285,0.8571428571428571,1,6
CCOC(=O)c1cncn1C(C)c1ccc(F)cc1,35,7,28,0.2,0.8,0,4
OC(CCCN1CCc2c(c3cc(F)ccc3n2-c2ccc(F)cc2)C1)c1ccc(F)cc1,62,7,55,0.11290322580645161,0.8870967741935484,1,3
CC(C)n1c(/C=C/[C@@H](O)C[C@H](O)CC(=O)O)c(-c2ccc(F)cc2)c2ccccc21,58,13,45,0.22413793103448276,0.7758620689655172,3,5
COCCCC/C(=N\OCCN)c1ccc(C(F)(F)F)cc1.O=C(O)/C=C\C(=O)O,54,16,38,0.2962962962962963,0.7037037037037037,3,8
CNC(=O)N1CC(Oc2cccc(C(F)(F)F)c2)C1,33,6,27,0.18181818181818182,0.8181818181818182,1,2
Nc1nc(=O)c2nc(CNc3ccc(C(=O)N[C@@H](CCC(=O)O)C(=O)O)cc3)cnc2[nH]1,53,13,40,0.24528301886792453,0.7547169811320755,6,11
CC(=O)OCC(=O)[C@@]12OC(C)(C)O[C@@H]1CC1C3CC(C=O)=C4C=C(OCCCl)CCC4(C)[C@@]3(F)C(O)CC12C,81,14,67,0.1728395061728395,0.8271604938271605,1,8
CP(C)(=O)CN1C(=O)CN=C(c2ccccc2)c2cc(Cl)ccc21,44,5,39,0.11363636363636363,0.8863636363636364,0,3
NNC(=O)CP(=O)(c1ccccc1)c1ccccc1,35,6,29,0.17142857142857143,0.8285714285714286,2,3
C[C@@H]1O[C@@H]1P(=O)(O)O,15,4,11,0.26666666666666666,0.7333333333333333,2,4
O=C1NC(c2ccccc2)(c2ccccc2)C(=O)N1COP(=O)(O)O,42,7,35,0.16666666666666666,0.8333333333333334,3,6
CN1CCN(CCC(=O)N2c3ccccc3Sc3ccc(C(F)(F)F)cc32)CC1,54,6,48,0.1111111111111111,0.8888888888888888,0,4
O=C(CCN1CCN(CCO)CC1)N1c2ccccc2Sc2ccc(C(F)(F)F)cc21,58,8,50,0.13793103448275862,0.8620689655172413,1,5
O=C1OCCC1C1(O)CCN(CCCN2c3ccccc3Sc3ccc(Cl)cc32)CC1,62,6,56,0.0967741935483871,0.9032258064516129,1,6
C/C(=C(/CCO)SSCC1CCCO1)N(C=O)Cc1cnc(C)nc1N,53,14,39,0.2641509433962264,0.7358490566037735,2,8
O=c1[nH]oc2c1CCNC2,19,0,19,0.0,1.0,2,3
CC(=O)[C@H]1CC[C@H]2[C@@H]3CC[C@H]4C[C@](C)(O)CC[C@]4(C)[C@H]3CC[C@]12C,63,6,57,0.09523809523809523,0.9047619047619048,1,2
COCc1c(C(=O)OC(C)C)ncc2[nH]c3cccc(Oc4ccc(Cl)cc4)c3c12,54,10,44,0.18518518518518517,0.8148148148148148,1,5
CCC12CCN(CC3CC3)C(Cc3ccc(O)cc31)C2(C)C,54,7,47,0.12962962962962962,0.8703703703703703,1,2
CC1(C)CC(=O)N(CCCCN2CCN(c3ncccn3)CC2)C(=O)C1.[Cl-].[H+],57,8,49,0.14035087719298245,0.8596491228070176,0,6
Fc1ccc2[nH]c3c(c2c1)CN(CCCc1cccnc1)CC3,46,4,42,0.08695652173913043,0.9130434782608695,1,2
COc1cc2c(cc1OC)C(c1cccc(Cl)c1)=NN=C(C)C2,42,6,36,0.14285714285714285,0.8571428571428571,0,4
CC1(C)O[C@@H]2C[C@H]3[C@@H]4CCC5=CC(=O)CC[C@]5(C)[C@@]4(F)[C@@H](O)C[C@]3(C)[C@]2(C(=O)CCl)O1,67,7,60,0.1044776119402985,0.8955223880597015,1,5
C[C@@H]1C[C@H]2[C@@H]3C[C@H](F)C4=CC(=O)C=C[C@]4(C)C3(Cl)[C@@H](F)C[C@]2(C)[C@H]1C(=O)CO,58,6,52,0.10344827586206896,0.896551724137931,1,3
O=C(NCCN1CCC(n2c(=O)[nH]c3cc(Cl)ccc32)CC1)c1ccc(F)cc1,54,6,48,0.1111111111111111,0.8888888888888888,2,4
CCCCCCCCCC(=O)OC1(c2ccc(Cl)cc2)CCN(CCCC(=O)c2ccc(F)cc2)CC1,80,17,63,0.2125,0.7875,0,4
C[C@]12C=C(Br)C(=O)C=C1[C@H](F)C[C@H]1[C@@H]3CCC(O)(C(=O)CO)[C@@]3(C)C[C@H](O)C12F,57,7,50,0.12280701754385964,0.8771929824561403,3,5
O=C1CN2CCOC2(c2ccccc2F)c2cc(Br)ccc2N1,40,1,39,0.025,0.975,1,3
CCCCCC(N)C(O)(c1ccccc1)c1ccccc1,47,10,37,0.2127659574468085,0.7872340425531915,2,2
OCCN1C=CN(CCCN2c3ccccc3C=Cc3ccccc32)C=CC1,58,7,51,0.1206896551724138,0.8793103448275862,1,4
CCC(C)(O)C1CC23C=CC1(OC)C1Oc4c(OC)ccc5c4C12CCN(CC1CC1)C3C5,76,11,65,0.14473684210526316,0.8552631578947368,1,5
CC(C)(CO)[C@@H](O)C(=O)NCCCC(=O)O,34,13,21,0.38235294117647056,0.6176470588235294,4,5
CCN(CC)CC(=O)OCC(=O)[C@@]1(O)CC[C@H]2[C@@H]3CCC4=CC(=O)CC[C@]4(C)[C@H]3[C@@H](O)C[C@@]21C,78,14,64,0.1794871794871795,0.8205128205128205,2,7
CCC(=O)O[C@]1(C(=O)COC(C)=O)CC[C@H]2[C@@H]3CCC4=CC(=O)CC[C@]4(C)[C@H]3[C@@H](O)C[C@@]21C,72,12,60,0.16666666666666666,0.8333333333333334,1,7
C[C@]12CCC(=O)C=C1CC[C@@H]1[C@@H]2[C@@H](O)C[C@@]2(C)[C@H]1CC[C@]2(O)C(=O)COC(=O)CCC(=O)O.O,72,12,60,0.16666666666666666,0.8333333333333334,3,8
CCCCC(=O)O[C@]1(C(=O)CO)CCC2C3CCC4=CC(=O)CCC4(C)C3C(O)CC21C,73,12,61,0.1643835616438356,0.8356164383561644,2,6
CC12CCC(=O)C=C1CCC1C2C(O)CC2(C)C1CCC2(O)C(=O)COC(=O)CCC1CCCC1,81,11,70,0.13580246913580246,0.8641975308641975,2,6
CN1CC[C@]23c4c5ccc(O)c4O[C@H]2[C@@H](O)CC[C@@]3(O)[C@H]1C5,47,4,43,0.0851063829787234,0.9148936170212766,3,5
COc1ccc(Cn2c(C)c(CCN)c3cc(O)ccc32)cc1,47,9,38,0.19148936170212766,0.8085106382978723,2,4
CCC(Br)(C(N)=O)C(C)C,23,7,16,0.30434782608695654,0.6956521739130435,1,1
O=C1CN=C(c2ccccc2)c2cc(Cl)ccc2N1CCOCC1CC1,50,6,44,0.12,0.88,0,3
Cc1cccc(O[C@H]2CCNC[C@H]2O)c1C,36,5,31,0.1388888888888889,0.8611111111111112,2,3
O=C(/C=C/c1ccc2c(c1)OCO2)N1CCCCC1,38,3,35,0.07894736842105263,0.9210526315789473,0,3
COc1cc(C(C)=O)ccc1OCCCN1CCC(c2noc3cc(F)ccc23)CC1,61,10,51,0.16393442622950818,0.8360655737704918,0,6
CN1CCN(CCN2CCN(CCCN3c4ccccc4Sc4ccc(Cl)cc43)CC2)C1=O,69,8,61,0.11594202898550725,0.8840579710144928,0,5
CN(C)CCN1CCN(c2cccc(Cl)c2)C1=O,37,6,31,0.16216216216216217,0.8378378378378378,0,2
C[N+](C)([O-])CCCN1c2ccccc2CCc2ccccc21,48,6,42,0.125,0.875,0,2
CN[C@@H]1C[C@@H](c2ccc(Cl)c(Cl)c2)c2ccccc21.[Cl-].[H+],36,3,33,0.08333333333333333,0.9166666666666666,1,1
C1=Cc2cccc(OCC3CNCCO3)c2C1,36,3,33,0.08333333333333333,0.9166666666666666,1,3
COc1ccc2c(c1)c(CC(=O)O)c(C)n2C(=O)c1ccc(Cl)cc1,43,8,35,0.18604651162790697,0.813953488372093,1,5
CN(C)CCC1(c2ccccc2)C=Cc2ccccc21,43,6,37,0.13953488372093023,0.8604651162790697,0,1
CC(C)NNC(=O)COc1ccc(Cl)cc1,31,8,23,0.25806451612903225,0.7419354838709677,2,3
CSc1c(Cl)nc(NC(C)C)nc1N1CCN(C)CC1,43,8,35,0.18604651162790697,0.813953488372093,1,6
O=C1c2ccccc2S(=O)(=O)N1CCCCN1CCN(c2ncccn2)CC1.[Cl-].[H+],54,6,48,0.1111111111111111,0.8888888888888888,0,7
Cc1cc(C(=O)NNCc2ccccc2)no1,31,6,25,0.1935483870967742,0.8064516129032258,2,4
CC12C=CC(=O)C=C1CCC1C3CCC(O)(C(=O)CO)C3(C)CC(O)C12F,57,7,50,0.12280701754385964,0.8771929824561403,3,5
CC(=O)OCC(=O)[C@@]1(O)CC[C@H]2[C@@H]3CCC4=CC(=O)C=C[C@]4(C)[C@@]3(F)[C@@H](O)C[C@@]21C,62,9,53,0.14516129032258066,0.8548387096774194,2,6
CCC[C@@H]1O[C@@H]2C[C@H]3[C@@H]4C[C@H](F)C5=CC(=O)C=C[C@]5(C)C4(F)[C@@H](O)C[C@]3(C)[C@]2(C(=O)O[C@H](C)OC(=O)OCC)O1,82,15,67,0.18292682926829268,0.8170731707317073,1,9
C=C[C@@H]1CNCC[C@H]1CCCc1ccnc2ccc(OC)cc12,51,7,44,0.13725490196078433,0.8627450980392157,1,3
CC1[C@H]2C(=O)c3ccc(O)cc3[C@]1(C)CCN2CC1CC1,47,5,42,0.10638297872340426,0.8936170212765957,1,3
CC1=CC(=O)N2CC(=O)N(C)c3ccc(Cl)cc3C2(c2ccccc2)O1,46,3,43,0.06521739130434782,0.9347826086956522,0,3
CCC(=O)C1(c2cccc(O)c2)CCN(C)CC1,40,6,34,0.15,0.85,1,3
Clc1cnn(CCCCN2CCN(c3ncccn3)CC2)c1,45,6,39,0.13333333333333333,0.8666666666666667,0,6
O=C(CN1CCC23CCCCC2C1Cc1ccc(O)cc13)c1ccccc1,58,4,54,0.06896551724137931,0.9310344827586207,1,3
O=C1N(c2ccccc2)c2ccccc2C1(Cc1ccncc1)Cc1ccncc1,55,5,50,0.09090909090909091,0.9090909090909091,0,3
CCN(CC)C(=O)N[C@H]1C=C2c3cccc4[nH]cc(c34)C[C@H]2N(C)C1,54,8,46,0.14814814814814814,0.8518518518518519,2,2
CNCCC=C1c2ccccc2C(C)(C)c2ccccc21,46,6,40,0.13043478260869565,0.8695652173913043,1,1
O=C1CCNc2ccc(Cl)cc2N1c1ccccc1,34,1,33,0.029411764705882353,0.9705882352941176,1,2
CCC(=O)N(c1ccccc1)[C@]1(C(=O)OC)CCN(CCc2ccccc2)C[C@@H]1C,64,12,52,0.1875,0.8125,0,4
CN(CCCN1c2ccccc2CCc2ccccc21)CC(=O)c1ccc(Cl)cc1.[Cl-].[H+],60,8,52,0.13333333333333333,0.8666666666666667,0,3
COc1ccc(Cl)c2c1CCCC2N(C)C,35,5,30,0.14285714285714285,0.8571428571428571,0,2
O=C1Nc2ccc(Cl)nc2C(c2ccccc2Cl)=NC1O,32,2,30,0.0625,0.9375,2,4
CN1CCN(/C=C2\N=C3CN=C(c4ccccc4Cl)c4cc([N+](=O)[O-])ccc4N3C2=O)CC1,58,4,54,0.06896551724137931,0.9310344827586207,0,7
CN1C(=O)C(O)N=C(c2ccccc2Cl)c2cc(Cl)ccc21,36,3,33,0.08333333333333333,0.9166666666666666,1,3
FC(F)(F)c1cccc(N2CCN(CCc3nnc4n3C[C@H]3CCC[C@@H]43)CC2)c1,59,5,54,0.0847457627118644,0.9152542372881356,0,5
CN1CC[C@]23NC(=O)CC(c4cc(Cl)ccc4O2)C3C1,40,1,39,0.025,0.975,1,3
CN(C(=O)CNC(=O)CN)c1ccc(Cl)cc1C(=O)c1ccccc1Cl.O,46,10,36,0.21739130434782608,0.782608695652174,2,4
COC1=CC(=O)OC1C(O)c1ccccc1Cl,29,5,24,0.1724137931034483,0.8275862068965517,1,4
CCOC(=O)OC1(C(=O)OCCl)CCC2C3CCC4=CC(=O)C=CC4(C)C3C(O)CC21C,66,11,55,0.16666666666666666,0.8333333333333334,1,7
CN1CCN(C2=Nc3ccccc3Oc3ccc(Cl)cc32)CC1,44,2,42,0.045454545454545456,0.9545454545454546,0,4
CN1c2cc(F)ccc2C(c2ccccc2)=NCC1CNC(=O)c1ccoc1,51,6,45,0.11764705882352941,0.8823529411764706,1,4
OC1(c2ccc(Cl)cc2)c2ccccc2C2=NCCN21,36,2,34,0.05555555555555555,0.9444444444444444,1,3
CN1CCN(CC(=O)[C@@]2(O)CC[C@H]3[C@@H]4CCC5=CC(=O)C=C[C@]5(C)[C@H]4[C@@H](O)C[C@@]32C)CC1,74,8,66,0.10810810810810811,0.8918918918918919,2,6
CC(NN)c1ccccc1,22,4,18,0.18181818181818182,0.8181818181818182,2,2
CCC(C)C(C)(COC(N)=O)COC(N)=O,35,13,22,0.37142857142857144,0.6285714285714286,2,4
C[C@@H]1N=C(c2ccccc2Cl)c2cc([N+](=O)[O-])ccc2NC1=O,37,3,34,0.08108108108108109,0.918918918918919,1,4
CNC(=O)NC(O)C(Cl)(Cl)Cl,17,6,11,0.35294117647058826,0.6470588235294118,3,2
C[C@@H]1CC2C3CCC4=CC(=O)C=CC4(C)[C@@]3(Cl)C(Cl)CC2(C)[C@@]1(O)C(=O)CO,59,7,52,0.11864406779661017,0.8813559322033898,2,4
CC(=O)[C@H]1CC[C@H]2[C@@H]3C[C@H](C)C4=CC(=O)CC[C@]4(C)[C@H]3[C@@H](O)C[C@]12C,60,6,54,0.1,0.9,1,3
CCN(CC)CCNC(=O)COc1ccc(OC)cc1.[Cl-].[H+],44,13,31,0.29545454545454547,0.7045454545454546,1,4
CN(C)CCC=C1c2ccccc2C(C)(C)c2ccccc21,49,7,42,0.14285714285714285,0.8571428571428571,0,1
CC1CCN(CCCC(=O)c2ccc(F)cc2)CC1,42,6,36,0.14285714285714285,0.8571428571428571,0,2
CC12CC3CC(C)(C1)CC(N)(C3)C2,36,3,33,0.08333333333333333,0.9166666666666666,1,1
COc1ccccc1OCC1CNC(=O)O1,30,5,25,0.16666666666666666,0.8333333333333334,1,4
COc1ccc2c(c1)C(O)(CCCN(C)C)c1ccccc1S2,48,9,39,0.1875,0.8125,1,4
CN1C[C@@H](NS(=O)(=O)N(C)C)C[C@@H]2c3cccc4c3c(cn4C)C[C@H]21,54,7,47,0.12962962962962962,0.8703703703703703,1,4
CC(=O)Nc1cccc(O)c1,20,4,16,0.2,0.8,2,2
CC(C)(O)C(C)(O)c1cccc(Cl)c1,29,7,22,0.2413793103448276,0.7586206896551724,2,2
CN(C)CCN(Cc1cccs1)c1ccccn1,38,8,30,0.21052631578947367,0.7894736842105263,0,4
CCC1(CC)C(=O)NC(=O)N(C)C1=O,28,5,23,0.17857142857142858,0.8214285714285714,1,3
CCCC(C)C1(CCSC)C(=O)NC(=S)NC1=O,38,9,29,0.23684210526315788,0.7631578947368421,2,4
CC1=CCC2C3Cc4ccc(O)c5c4C2(CCN3C)C1O5,46,3,43,0.06521739130434782,0.9347826086956522,1,3
CO[C@H]1CC[C@H]2[C@H]3Cc4ccc(O)c5c4[C@@]2(CCN3C)[C@H]1O5,49,4,45,0.08163265306122448,0.9183673469387755,1,4
CCC(=O)O[C@]1(C(=O)COC(C)=O)CC[C@H]2[C@@H]3C[C@H](C)C4=CC(=O)C=C[C@]4(C)[C@H]3[C@@H](O)C[C@@]21C,73,13,60,0.1780821917808219,0.821917808219178,1,7
Cc1ccc2c(c1)C(N1CCN(C)CC1)=Nc1ccccc1S2,47,3,44,0.06382978723404255,0.9361702127659575,0,4
COc1cc(C(=O)OCCN2CCN(CCCN3c4ccccc4Sc4ccc(Cl)cc43)CC2)cc(OC)c1OC,81,15,66,0.18518518518518517,0.8148148148148148,0,9
CS(=O)(=O)c1ccc2c(c1)N(CCCN1CCC(C(N)=O)CC1)c1ccccc1S2,60,8,52,0.13333333333333333,0.8666666666666667,1,6
CN1CC[C@]23c4c5ccc(O)c4O[C@@]2(C)C(=O)CC[C@H]3[C@H]1C5,47,3,44,0.06382978723404255,0.9361702127659575,1,4
COC(=O)C1C2CC3c4[nH]c5cc(OC)ccc5c4CCN3CC2CC(OC)C1OC,67,9,58,0.13432835820895522,0.8656716417910447,1,6
COc1ccc2c(c1)C(N1CCN(C)CC1)=Cc1ccccc1O2,49,4,45,0.08163265306122448,0.9183673469387755,0,4
COc1ccc2c(c1)c1c3n2CCN(C)C3=NCC1,39,3,36,0.07692307692307693,0.9230769230769231,0,4
CC[C@H](C)C(=O)O[C@H]1CCC=C2C=C[C@H](C)[C@H](CC[C@@H]3C[C@@H](O)CC(=O)O3)[C@H]21,64,11,53,0.171875,0.828125,1,5
CC1COC2(c3ccccc3Cl)c3cc(Cl)ccc3NC(=O)CN12,43,2,41,0.046511627906976744,0.9534883720930233,1,3
CNc1nc(Cl)c(SC)c(N2CCN(C)CC2)n1,37,6,31,0.16216216216216217,0.8378378378378378,1,6
Clc1ccc(COC(Cn2ccnc2)c2ccc(Cl)cc2Cl)c(Cl)c1,41,6,35,0.14634146341463414,0.8536585365853658,0,3
NC1=NC(C(F)(F)F)(C(F)(F)F)NC1(C(F)(F)F)C(F)(F)F,25,5,20,0.2,0.8,2,3
CCCCCNCC(N)=O,25,8,17,0.32,0.68,2,2
CO/N=C/C1=CCCN(C)C1,25,4,21,0.16,0.84,0,3
Cc1cc(-c2ccccc2)nnc1NCCN1CCOCC1,46,6,40,0.13043478260869565,0.8695652173913043,1,5
CCO[C@H]1C[C@@]2(C)[C@@H](CC[C@@H]3[C@@H]2[C@H](N(C)C)C[C@]2(C)[C@@H](C(C)=O)CC[C@@H]32)C[C@@H]1O,75,11,64,0.14666666666666667,0.8533333333333334,1,4
CN1[C@@H]2CC[C@H]1CC(NC(=O)c1cn(C3CCCCC3)c3ccccc3c1=O)C2,64,5,59,0.078125,0.921875,1,4
O=C(NCCN1CCOCC1)c1ccc(Cl)cc1,36,5,31,0.1388888888888889,0.8611111111111112,1,3
NC(=O)CS(=O)C(c1ccccc1)c1ccccc1,35,6,29,0.17142857142857143,0.8285714285714286,1,2
C[C@@H]1C[C@H]2[C@@H]3CCC4=CC(=O)C=C[C@]4(C)[C@@]3(Cl)[C@@H](O)C[C@]2(C)[C@@]1(O)C(=O)CCl,59,7,52,0.11864406779661017,0.8813559322033898,2,4
CNCCCN1c2ccccc2C(C)(C)c2ccccc21,47,7,40,0.14893617021276595,0.851063829787234,1,2
CC1(c2ccccc2)CC(=O)N(CN2CCOCC2)C1=O,43,4,39,0.09302325581395349,0.9069767441860465,0,4
O=C1NC2CCCCN2C12CCN(CCCN1c3ccccc3CCc3ccc(Cl)cc31)CC2,74,4,70,0.05405405405405406,0.9459459459459459,1,4
COCN1C(=O)CN=C(c2ccccc2)c2cc([N+](=O)[O-])ccc21,41,5,36,0.12195121951219512,0.8780487804878049,0,5
CNC(=O)O[C@H]1OC(=O)[C@@]2(C)[C@@H]1[C@H]1C=C[C@@H]2C1,34,5,29,0.14705882352941177,0.8529411764705882,1,4
CC1=CC(=C2C=CC(=O)C=C2)NN=C1NCCN1CCOCC1,47,5,42,0.10638297872340426,0.8936170212765957,2,6
CCCCCCCCCCCCCC(=O)O[C@H]1C=C[C@H]2[C@H]3Cc4ccc(OCc5ccccc5)c5c4[C@@]2(CCN3C)[C@H]1O5,99,19,80,0.1919191919191919,0.8080808080808081,0,5
CCCCCC(C)C(C)c1cc(OC(=O)CCCN2CCCCCC2)c2c(c1)OC(C)(C)C1=C2CC(C)CC1,97,18,79,0.18556701030927836,0.8144329896907216,0,4
CCCCCCC(C)(C)c1cc(O)c2c(c1)OC(C)(C)[C@@H]1CCC(=O)C[C@@H]21,65,12,53,0.18461538461538463,0.8153846153846154,1,3
O=C(Cn1ccnc1)c1ccc2ccccc2c1,32,3,29,0.09375,0.90625,0,3
C[C@]12C=CC(=O)C=C1CC[C@H]1[C@@H]3C[C@H]4Cc5ccccc5C[C@@]4(C(=O)CO)[C@@]3(C)C[C@H](O)[C@@]12F.O,74,6,68,0.08108108108108109,0.918918918918919,2,4
Oc1ccc2c3c1OC1C(O)CCC4(O)C(C2)N(CC2CCC2)CCC314,58,5,53,0.08620689655172414,0.9137931034482759,3,5
C=C1CC[C@@]2(O)[C@H]3Cc4ccc(O)c5c4[C@@]2(CCN3CC2CC2)[C@H]1O5,55,4,51,0.07272727272727272,0.9272727272727272,2,4
CC(C)=CCN1CC[C@]23c4c5ccc(O)c4O[C@H]2C(=O)CC[C@@]3(O)[C@H]1C5,55,6,49,0.10909090909090909,0.8909090909090909,2,5
CN=C(Cc1ccc2ccccc2c1)[NH2+]C.[Cl-],34,5,29,0.14705882352941177,0.8529411764705882,1,1
C1=C(CC2=NCNC2)CCc2ccccc21,34,2,32,0.058823529411764705,0.9411764705882353,1,2
CC(Oc1cccc2ccccc12)/C(N)=N/O,32,6,26,0.1875,0.8125,2,3
CCc1nn(CCCN2CCN(c3cccc(Cl)c3)CC2)c(=O)n1CCOc1ccccc1.[Cl-].[H+],68,11,57,0.16176470588235295,0.8382352941176471,0,7
Cc1cccc(C)c1NC(=O)CN1CCCC1=O,37,6,31,0.16216216216216217,0.8378378378378378,1,2
O=c1[nH]c2ccccc2n1C1CCN(CCCc2noc3cc(F)ccc23)CC1,56,5,51,0.08928571428571429,0.9107142857142857,1,5
O=C(CCNNC(=O)c1ccncc1)NCc1ccccc1,41,9,32,0.21951219512195122,0.7804878048780488,3,4
CC(CCN1CCN(c2ccc(F)cc2)CC1)NC(=O)c1cccnc1,53,8,45,0.1509433962264151,0.8490566037735849,1,4
C/C=C\C1O[C@]2(C(=O)COC(=O)c3ccncc3)CC[C@@]3(O1)[C@@H]1CCC4=CC(=O)CC[C@]4(C)[C@H]1[C@@H](O)C[C@]23C,81,10,71,0.12345679012345678,0.8765432098765432,1,8
CN1CC[C@]23c4c5ccc(OC(=O)c6cccnc6)c4O[C@H]2[C@@H](OC(=O)c2cccnc2)C=C[C@H]3[C@H]1C5,68,7,61,0.10294117647058823,0.8970588235294118,0,8
O=C(c1cccnc1)N1CCOCC1,27,2,25,0.07407407407407407,0.9259259259259259,0,3
NC(=O)c1cccnc1,15,2,13,0.13333333333333333,0.8666666666666667,1,2
CCN(CC)C(=O)c1cccnc1,27,6,21,0.2222222222222222,0.7777777777777778,0,2
CN1C(=O)CN=C(c2ccccc2)c2cc([N+](=O)[O-])ccc21,37,3,34,0.08108108108108109,0.918918918918919,0,4
CCC(C)C(C)(COC(N)=O)COC(=O)NC(C)C,44,16,28,0.36363636363636365,0.6363636363636364,2,4
CNCCC(Oc1ccccc1OC)c1ccccc1,42,9,33,0.21428571428571427,0.7857142857142857,1,3
N=C(N)c1ccc(-c2ccccc2[N+](=O)[O-])o1,27,4,23,0.14814814814814814,0.8518518518518519,2,4
C#C[C@]1(O)CC[C@H]2C3CCC4=Cc5c(cnn5-c5ccc(F)cc5)CC4(C)[C@H]3CCC21C,68,4,64,0.058823529411764705,0.9411764705882353,1,3
CNC/C=C(/c1ccc(Br)cc1)c1cccnc1,34,5,29,0.14705882352941177,0.8529411764705882,1,2
CN1Cc2c(N)cccc2C(c2ccccc2)C1,38,3,35,0.07894736842105263,0.9210526315789473,1,2
CCCCCCCCCNc1ncnc2[nH]ccc12,44,10,34,0.22727272727272727,0.7727272727272727,2,3
FCC(F)(F)F,7,1,6,0.14285714285714285,0.8571428571428571,0,0
Oc1ccc2c(c1)C13CCCCC1C(C2)NCC3,42,1,41,0.023809523809523808,0.9761904761904762,2,2
Oc1ccc2c3c1OC1C(O)C=CC4C(C2)NCCC341,41,2,39,0.04878048780487805,0.9512195121951219,3,4
O=C1CN=C(C2=CCCCC2)c2cc(Cl)ccc2N1,36,1,35,0.027777777777777776,0.9722222222222222,1,2
COc1ccc2c(c1OC)C(=O)O[C@@H]2[C@H]1c2c(cc3c(c2OC)OCO3)CCN1C,57,8,49,0.14035087719298245,0.8596491228070176,0,8
CN(C)CCON=C1c2ccccc2CCc2ccccc21,46,6,40,0.13043478260869565,0.8695652173913043,0,3
Clc1ccc2c(c1)/C(=C/C1CN3CCC1CC3)c1ccccc1S2,48,1,47,0.020833333333333332,0.9791666666666666,0,2
Cc1nc2c(C)cccn2c(=O)c1CCN1CCC(c2noc3cc(F)ccc23)CC1,60,6,54,0.1,0.9,0,6
O=C(c1ccccn1)c1cnn2c(-c3ccncc3)ccnc12,37,3,34,0.08108108108108109,0.918918918918919,0,6
CCCCCCC(C)NN,29,9,20,0.3103448275862069,0.6896551724137931,2,2
CNCCC=C1c2ccccc2C2CC2c2ccccc21,45,4,41,0.08888888888888889,0.9111111111111111,1,1
O=C(CN1CC[C@H](c2ccc(F)cc2)[C@@H](COc2ccc3c(c2)OCO3)C1)c1ccc(F)cc1,63,7,56,0.1111111111111111,0.8888888888888888,0,5
CC(C)N1CCOC(c2ccc(C(F)(F)F)cc2)C1,38,5,33,0.13157894736842105,0.868421052631579,0,2
NC(=O)N1c2ccccc2CC(=O)c2ccccc21,33,2,31,0.06060606060606061,0.9393939393939394,1,2
CC(Cc1ccccc1)[N+](C)([O-])Cc1ccccc1,41,7,34,0.17073170731707318,0.8292682926829268,0,1
NC(=O)CN1CC(O)CC1=O,21,4,17,0.19047619047619047,0.8095238095238095,2,3
COC(=O)[C@@]1(O)CC[C@H]2C3CCC(=O)C4C(=O)C=CC4(C)[C@H]3C(O)CC21C,58,7,51,0.1206896551724138,0.8793103448275862,2,6
NC(Cc1c[nH]c2ccc(O)cc12)C(=O)O,29,6,23,0.20689655172413793,0.7931034482758621,4,4
CN(C)C(=O)COC1c2ccccc2CCc2ccccc21,45,6,39,0.13333333333333333,0.8666666666666667,0,2
CC(C)CCC(=O)CC1c2ccccc2C(=O)N1c1ccc2ccc(Cl)nc2n1,54,8,46,0.14814814814814814,0.8518518518518519,0,4
CC(C)n1c(=O)c2c(-c3noc(C4CC4)n3)ncn2c2ccccc21,46,5,41,0.10869565217391304,0.8913043478260869,0,7
COc1ccc(N2C[C@H](CN3CCC(O)(c4ccc5c(c4)OCO5)CC3)OC2=O)cc1,61,7,54,0.11475409836065574,0.8852459016393442,1,7
Nc1cc(OCC2CC2)c(C(=O)NC2CN3CCC2CC3)cc1Cl,51,7,44,0.13725490196078433,0.8627450980392157,2,4
O=C(NC(=O)c1ccccc1)NC1CCN(Cc2ccc3ccccc3c2)CC1,57,7,50,0.12280701754385964,0.8771929824561403,2,3
CC1OC(C)OC(C)O1,21,3,18,0.14285714285714285,0.8571428571428571,0,3
CC(=O)OCC(=O)[C@@]1(O)[C@H](C)C[C@H]2[C@@H]3C[C@H](F)C4=CC(=O)C=C[C@]4(C)[C@H]3[C@@H](O)C[C@@]21C,65,10,55,0.15384615384615385,0.8461538461538461,2,6
C#CCN(C)Cc1ccccc1,25,4,21,0.16,0.84,0,1
Fc1ccc([C@@H]2CCNC[C@H]2COc2ccc3c(c2)OCO3)cc1,47,4,43,0.0851063829787234,0.9148936170212766,1,4
O=C(CC1c2ccccc2C(=O)N1c1ccc2ccc(Cl)nc2n1)N1CCC2(CC1)OCCO2,62,4,58,0.06451612903225806,0.9354838709677419,0,6
OC1(c2ccc(Cl)c(C(F)(F)F)c2)CCN(CCCC(c2ccc(F)cc2)c2ccc(F)cc2)CC1,66,9,57,0.13636363636363635,0.8636363636363636,1,2
CC(OC(N)=O)C(C)C(C)OC(N)=O,29,11,18,0.3793103448275862,0.6206896551724138,2,4
CCCCCN[C@@]12C=CC(=O)[C@@H]3Oc4c(O)ccc5c4[C@@]31CCN(C)[C@@H]2C5,59,8,51,0.13559322033898305,0.864406779661017,2,5
OCC1(CO)COC(C(Cl)(Cl)Cl)OC1,25,5,20,0.2,0.8,2,4
CN1CCN(C2=Nc3ccccc3Sc3nccn32)CC1,41,2,39,0.04878048780487805,0.9512195121951219,0,6
c1ccc(-c2nc(N3CCNCC3)cc3ccccc23)cc1,44,2,42,0.045454545454545456,0.9545454545454546,1,3
O=C1[C@H]2CCCC[C@H]2C(=O)N1CCCCN1CCN(c2nsc3ccccc23)CC1,64,6,58,0.09375,0.90625,0,6
OCCN1CCN(CCCN2c3ccccc3Sc3ccc(Cl)cc32)CC1,56,7,49,0.125,0.875,1,5
OC(OCC(COC(O)C(Cl)(Cl)Cl)(COC(O)C(Cl)(Cl)Cl)COC(O)C(Cl)(Cl)Cl)C(Cl)(Cl)Cl,48,20,28,0.4166666666666667,0.5833333333333334,4,8
NC(=O)NC(=O)Cc1ccccc1,23,5,18,0.21739130434782608,0.782608695652174,2,2
CC1C2Cc3ccc(O)cc3C1(C)CCN2CCc1ccccc1,54,6,48,0.1111111111111111,0.8888888888888888,1,2
CCC(C(=O)NC(N)=O)c1ccccc1,29,7,22,0.2413793103448276,0.7586206896551724,2,2
CC1NCCOC1c1ccccc1,29,2,27,0.06896551724137931,0.9310344827586207,1,2
CC(COc1ccccc1)NN,26,6,20,0.23076923076923078,0.7692307692307693,2,3
CN1C(=O)CC(c2ccccc2)C1=O,26,2,24,0.07692307692307693,0.9230769230769231,0,2
O=C([O-])c1ccccc1Oc1ccccc1,26,3,23,0.11538461538461539,0.8846153846153846,0,3
O=C1NC(=O)C(c2ccccc2)(c2ccccc2)N1,33,2,31,0.06060606060606061,0.9393939393939394,2,2
CCC1(CC)C(=O)NC(=O)N(c2ccccc2)C1=O,36,5,31,0.1388888888888889,0.8611111111111112,1,3
O=C(c1ccccn1)N1CCN(Cc2ccccc2)CC1,42,4,38,0.09523809523809523,0.9047619047619048,0,3
CCC[C@]1(c2cccc(O)c2)CCN(C)C[C@@H]1C,44,7,37,0.1590909090909091,0.8409090909090909,1,2
CC(=O)Nc1ccc(OC(=O)[C@@H]2CCC(=O)N2)cc1,34,6,28,0.17647058823529413,0.8235294117647058,2,4
c1ccc(-c2cc(CCC3CCNCC3)c3ccccc3n2)cc1,51,4,47,0.0784313725490196,0.9215686274509803,1,2
CC(=O)c1ccc2c(c1)N(CCCN1CCC(CCO)CC1)c1ccccc1S2,62,9,53,0.14516129032258066,0.8548387096774194,1,5
O=C(OCCN1CCCCC1)C(O)(c1ccccc1)c1ccccc1,52,8,44,0.15384615384615385,0.8461538461538461,1,4
CN1CCN(c2cc3c(nn2)Oc2ccccc2N3C)CC1,44,3,41,0.06818181818181818,0.9318181818181818,0,6
CCCCCCCCCCCCCCCC(=O)OCCC1CCN(CCCN2c3ccccc3Sc3ccc(S(=O)(=O)N(C)C)cc32)CC1,115,27,88,0.23478260869565218,0.7652173913043478,0,7
CCc1c(C)[nH]c2c1C(=O)[C@@H]1CN(C)CC[C@H]1C2,42,4,38,0.09523809523809523,0.9047619047619048,1,2
NC(=O)CN1CCCC1=O,20,3,17,0.15,0.85,1,2
